Day,Borough,Swimming Pool,Program Type,Male Registration,Female Registration,Total Registration,Male Attendance,Female Attendance,Total Attendance
08/30/2019,Staten Island,Lyons,Night Owl,0,0,0,3,14,17
08/30/2019,Queens,Astoria,Night Owl,0,0,0,10,19,29
08/30/2019,Bronx,Crotona,Night Owl,0,0,0,1,1,2
08/30/2019,Bronx,Van Cortlandt,Night Owl,0,0,0,7,17,24
08/30/2019,Brooklyn,Sunset,Night Owl,0,0,0,18,9,27
08/30/2019,Brooklyn,Red Hook,Night Owl,0,0,0,13,12,25
08/30/2019,Brooklyn,McCarren,Night Owl,0,0,0,42,38,80
08/30/2019,Manhattan,Tony Dapolito,Night Owl,0,0,0,1,2,3
08/30/2019,Manhattan,Marcus Garvey,Night Owl,0,1,1,5,17,22
08/30/2019,Manhattan,Asser Levy,Night Owl,0,0,0,9,4,13
08/30/2019,Manhattan,Lasker,Night Owl,0,0,0,10,15,25
08/30/2019,Manhattan,John Jay,Night Owl,0,0,0,30,26,56
08/30/2019,Manhattan,Hamilton Fish,Night Owl,0,0,0,14,12,26
08/29/2019,Staten Island,Lyons,Night Owl,0,0,0,5,4,9
08/29/2019,Queens,Astoria,Night Owl,1,0,1,12,16,28
08/29/2019,Bronx,Crotona,Night Owl,0,0,0,1,0,1
08/29/2019,Bronx,Van Cortlandt,Night Owl,0,0,0,6,16,22
08/29/2019,Brooklyn,Sunset,Night Owl,0,2,2,13,15,28
08/29/2019,Brooklyn,Red Hook,Night Owl,1,3,4,12,12,24
08/29/2019,Brooklyn,McCarren,Night Owl,0,2,2,45,46,91
08/29/2019,Manhattan,Tony Dapolito,Night Owl,0,1,1,3,7,10
08/29/2019,Manhattan,Marcus Garvey,Night Owl,0,2,2,7,11,18
08/29/2019,Manhattan,Asser Levy,Night Owl,0,1,1,19,14,33
08/29/2019,Manhattan,Lasker,Night Owl,0,2,2,17,21,38
08/29/2019,Manhattan,John Jay,Night Owl,3,2,5,22,26,48
08/29/2019,Manhattan,Hamilton Fish,Night Owl,0,0,0,10,12,22
08/28/2019,Staten Island,Lyons,Night Owl,0,0,0,2,0,2
08/28/2019,Queens,Astoria,Night Owl,0,1,1,3,7,10
08/28/2019,Bronx,Crotona,Night Owl,0,0,0,0,1,1
08/28/2019,Bronx,Van Cortlandt,Night Owl,0,0,0,3,5,8
08/28/2019,Brooklyn,Sunset,Night Owl,0,0,0,10,3,13
08/28/2019,Brooklyn,Red Hook,Night Owl,0,1,1,2,4,6
08/28/2019,Brooklyn,McCarren,Night Owl,1,1,2,19,12,31
08/28/2019,Manhattan,Tony Dapolito,Night Owl,0,0,0,4,2,6
08/28/2019,Manhattan,Marcus Garvey,Night Owl,0,0,0,3,1,4
08/28/2019,Manhattan,Asser Levy,Night Owl,0,0,0,6,6,12
08/28/2019,Manhattan,Lasker,Night Owl,0,0,0,9,7,16
08/28/2019,Manhattan,John Jay,Night Owl,3,2,5,12,6,18
08/28/2019,Manhattan,Hamilton Fish,Night Owl,0,0,0,3,4,7
08/27/2019,Staten Island,Lyons,Night Owl,0,0,0,3,4,7
08/27/2019,Queens,Astoria,Night Owl,1,2,3,20,16,36
08/27/2019,Bronx,Crotona,Night Owl,0,0,0,0,1,1
08/27/2019,Bronx,Van Cortlandt,Night Owl,0,0,0,4,3,7
08/27/2019,Brooklyn,Red Hook,Night Owl,0,2,2,7,9,16
08/27/2019,Brooklyn,Red Hook,Night Owl,0,4,4,8,9,17
08/27/2019,Brooklyn,McCarren,Night Owl,0,0,0,19,30,49
08/27/2019,Manhattan,Tony Dapolito,Night Owl,0,1,1,4,5,9
08/27/2019,Manhattan,Marcus Garvey,Night Owl,0,1,1,4,5,9
08/27/2019,Manhattan,Asser Levy,Night Owl,3,0,3,9,6,15
08/27/2019,Manhattan,Lasker,Night Owl,0,2,2,9,13,22
08/27/2019,Manhattan,John Jay,Night Owl,1,0,1,21,13,34
08/27/2019,Manhattan,Hamilton Fish,Night Owl,0,0,0,17,5,22
08/26/2019,Staten Island,Lyons,Night Owl,0,0,0,3,6,9
08/26/2019,Queens,Astoria,Night Owl,4,0,4,31,18,49
08/26/2019,Bronx,Crotona,Night Owl,0,1,1,0,1,1
08/26/2019,Bronx,Van Cortlandt,Night Owl,0,0,0,6,8,14
08/26/2019,Brooklyn,Sunset,Night Owl,2,3,5,20,16,36
08/26/2019,Brooklyn,Red Hook,Night Owl,0,1,1,13,11,24
08/23/2019,Brooklyn,McCarren,Night Owl,2,1,3,34,28,62
08/26/2019,Manhattan,Tony Dapolito,Night Owl,1,0,1,4,4,8
08/26/2019,Manhattan,Marcus Garvey,Night Owl,0,0,0,5,7,12
08/26/2019,Manhattan,Asser Levy,Night Owl,0,0,0,11,9,20
08/26/2019,Manhattan,Lasker,Night Owl,0,0,0,12,9,21
08/26/2019,Manhattan,John Jay,Night Owl,3,0,3,17,17,34
08/26/2019,Manhattan,Hamilton Fish,Night Owl,0,0,0,30,15,45
08/23/2019,Staten Island,Lyons,Night Owl,0,1,1,2,8,10
08/23/2019,Queens,Astoria,Night Owl,0,2,2,22,15,37
08/23/2019,Bronx,Crotona,Night Owl,0,0,0,2,1,3
08/23/2019,Bronx,Van Cortlandt,Night Owl,0,0,0,9,9,18
08/23/2019,Brooklyn,Sunset,Night Owl,0,0,0,19,7,26
08/23/2019,Brooklyn,Red Hook,Night Owl,0,1,1,10,4,14
08/23/2019,Brooklyn,McCarren,Night Owl,1,2,3,31,19,50
08/23/2019,Manhattan,Tony Dapolito,Night Owl,0,0,0,3,3,6
08/23/2019,Manhattan,Marcus Garvey,Night Owl,0,0,0,4,4,8
08/23/2019,Manhattan,Asser Levy,Night Owl,2,0,2,10,9,19
08/23/2019,Manhattan,Lasker,Night Owl,2,5,7,16,14,30
08/23/2019,Manhattan,John Jay,Night Owl,2,3,5,20,18,38
08/23/2019,Manhattan,Hamilton Fish,Night Owl,1,1,2,14,15,29
08/22/2019,Staten Island,Lyons,Night Owl,2,3,5,6,12,18
08/22/2019,Queens,Astoria,Night Owl,1,1,2,28,33,61
08/22/2019,Bronx,Crotona,Night Owl,0,0,0,2,2,4
08/22/2019,Bronx,Van Cortlandt,Night Owl,1,1,2,9,15,24
08/22/2019,Brooklyn,Sunset,Night Owl,0,0,0,0,0,0
08/22/2019,Brooklyn,Red Hook,Night Owl,1,3,4,12,16,28
08/22/2019,Brooklyn,McCarren,Night Owl,7,8,15,57,60,117
08/22/2019,Manhattan,Tony Dapolito,Night Owl,0,2,2,4,7,11
08/22/2019,Manhattan,Marcus Garvey,Night Owl,0,0,0,0,0,0
08/22/2019,Manhattan,Asser Levy,Night Owl,0,1,1,12,18,30
08/22/2019,Manhattan,Lasker,Night Owl,4,7,11,22,31,53
08/22/2019,Manhattan,John Jay,Night Owl,4,8,12,36,40,76
08/22/2019,Manhattan,Hamilton Fish,Night Owl,8,7,15,30,34,64
08/21/2019,Staten Island,Lyons,Night Owl,0,1,1,1,12,13
08/21/2019,Queens,Astoria,Night Owl,3,1,4,20,23,43
08/21/2019,Bronx,Crotona,Night Owl,0,0,0,1,0,1
08/21/2019,Bronx,Van Cortlandt,Night Owl,1,1,2,9,12,21
08/21/2019,Brooklyn,Sunset,Night Owl,0,0,0,18,1,19
08/21/2019,Brooklyn,Red Hook,Night Owl,2,0,2,12,10,22
08/21/2019,Brooklyn,McCarren,Night Owl,0,3,3,32,28,60
08/21/2019,Manhattan,Tony Dapolito,Night Owl,0,0,0,3,9,12
08/21/2019,Manhattan,Marcus Garvey,Night Owl,0,0,0,4,7,11
08/21/2019,Manhattan,Asser Levy,Night Owl,0,0,0,14,9,23
08/21/2019,Manhattan,Lasker,Night Owl,3,6,9,18,24,42
08/21/2019,Manhattan,John Jay,Night Owl,4,4,8,24,26,50
08/21/2019,Manhattan,Hamilton Fish,Night Owl,0,2,2,17,18,35
08/20/2019,Staten Island,Lyons,Night Owl,0,5,5,2,18,20
08/20/2019,Queens,Astoria,Night Owl,8,9,17,54,40,94
08/20/2019,Bronx,Crotona,Night Owl,0,0,0,3,2,5
08/20/2019,Bronx,Van Cortlandt,Night Owl,0,1,1,11,11,22
08/20/2019,Brooklyn,Sunset,Night Owl,2,5,7,19,16,35
08/20/2019,Brooklyn,Red Hook,Night Owl,2,5,7,19,16,35
08/20/2019,Brooklyn,McCarren,Night Owl,5,7,12,60,51,111
08/20/2019,Manhattan,Tony Dapolito,Night Owl,1,2,3,10,12,22
08/20/2019,Manhattan,Marcus Garvey,Night Owl,1,0,1,9,11,20
08/20/2010,Manhattan,Marcus Garvey,Night Owl,1,0,1,9,11,20
08/20/2019,Manhattan,Asser Levy,Night Owl,3,6,9,16,21,37
08/20/2019,Manhattan,Lasker,Night Owl,0,7,7,22,35,57
08/20/2019,Manhattan,John Jay,Night Owl,4,7,11,30,37,67
08/20/2019,Manhattan,Hamilton Fish,Night Owl,6,4,10,43,30,73
08/19/2019,Staten Island,Crotona,Night Owl,0,0,0,7,12,19
08/19/2019,Queens,Astoria,Night Owl,4,8,12,43,37,80
08/19/2019,Bronx,Crotona,Night Owl,0,1,1,2,2,4
08/19/2019,Bronx,Van Cortlandt,Night Owl,1,1,2,8,16,24
08/19/2019,Brooklyn,Sunset,Night Owl,4,1,5,30,17,47
08/19/2019,Brooklyn,Red Hook,Night Owl,1,8,9,14,20,34
08/19/2019,Brooklyn,McCarren,Night Owl,11,11,22,68,72,140
08/19/2019,Manhattan,Tony Dapolito,Night Owl,1,1,2,7,14,21
08/19/2019,Manhattan,Marcus Garvey,Night Owl,0,2,2,7,11,18
08/19/2019,Manhattan,Asser Levy,Night Owl,2,4,6,17,20,37
08/19/2019,Manhattan,Lasker,Night Owl,2,3,5,29,25,54
08/19/2019,Manhattan,John Jay,Night Owl,5,8,13,35,33,68
08/19/2019,Manhattan,Hamilton Fish,Night Owl,7,4,11,34,40,74
08/16/2019,Staten Island,Lyons,Night Owl,0,0,0,4,12,16
08/16/2019,Queens,Astoria,Night Owl,6,32,38,30,,30
08/16/2019,Bronx,Crotona,Night Owl,0,0,0,1,1,2
08/16/2019,Bronx,Van Cortlandt,Night Owl,2,1,3,12,13,25
08/16/2019,Brooklyn,Sunset,Night Owl,0,0,0,14,10,24
08/16/2019,Brooklyn,Red Hook,Night Owl,1,0,1,19,13,32
08/16/2019,Brooklyn,McCarren,Night Owl,1,4,5,46,36,82
08/16/2019,Manhattan,Tony Dapolito,Night Owl,1,0,1,9,6,15
08/16/2019,Manhattan,Marcus Garvey,Night Owl,1,4,5,6,12,18
08/16/2019,Manhattan,Asser Levy,Night Owl,2,0,2,16,10,26
08/16/2019,Manhattan,Lasker,Night Owl,5,2,7,13,19,32
08/16/2019,Manhattan,John Jay,Night Owl,2,0,2,32,30,62
08/16/2019,Manhattan,Hamilton Fish,Night Owl,3,0,3,30,21,51
08/15/2019,Staten Island,Lyons,Night Owl,0,0,0,3,7,10
08/15/2019,Queens,Astoria,Night Owl,7,8,15,35,36,71
08/15/2019,Bronx,Crotona,Night Owl,0,0,0,4,2,6
08/15/2019,Bronx,Van Cortlandt,Night Owl,0,1,1,10,36,46
08/15/2019,Brooklyn,Sunset,Night Owl,4,0,4,18,27,45
08/15/2019,Brooklyn,Red Hook,Night Owl,0,0,0,12,0,12
08/15/2019,Brooklyn,McCarren,Night Owl,9,10,19,35,50,85
08/15/2019,Manhattan,Tony Dapolito,Night Owl,0,1,1,5,7,12
08/15/2019,Manhattan,Marcus Garvey,Night Owl,2,2,4,11,12,23
08/15/2019,Manhattan,Lasker,Night Owl,0,4,4,15,28,43
08/15/2019,Manhattan,John Jay,Night Owl,6,8,14,25,23,48
08/15/2019,Manhattan,Hamilton Fish,Night Owl,7,3,10,22,39,61
08/14/2019,Staten Island,Lyons,Night Owl,0,0,0,3,3,6
08/14/2019,Queens,Astoria,Night Owl,2,2,4,35,28,63
08/14/2019,Bronx,Crotona,Night Owl,0,0,0,4,0,4
08/14/2019,Bronx,Van Cortlandt,Night Owl,2,0,2,10,4,14
08/14/2019,Brooklyn,Sunset,Night Owl,0,1,1,18,5,23
08/14/2019,Brooklyn,Red Hook,Night Owl,0,12,12,8,,8
08/14/2019,Brooklyn,McCarren,Night Owl,3,8,11,35,40,75
08/14/2019,Manhattan,Tony Dapolito,Night Owl,0,1,1,5,5,10
08/14/2019,Manhattan,Marcus Garvey,Night Owl,1,2,3,8,12,20
08/14/2019,Manhattan,Asser Levy,Night Owl,2,0,2,11,11,22
08/14/2019,Manhattan,Lasker,Night Owl,3,2,5,15,17,32
08/14/2019,Manhattan,John Jay,Night Owl,5,1,6,25,19,44
08/14/2019,Manhattan,Hamilton Fish,Night Owl,2,4,6,22,14,36
08/13/2019,Staten Island,Lyons,Early Bird,0,0,0,4,3,7
08/13/2019,Queens,Astoria,Night Owl,4,1,5,24,12,36
08/13/2019,Bronx,Crotona,Night Owl,0,0,0,4,1,5
08/13/2019,Bronx,Van Cortlandt,Night Owl,0,0,0,6,7,13
08/13/2019,Brooklyn,Sunset,Night Owl,0,0,0,16,12,28
08/13/2019,Brooklyn,Red Hook,Night Owl,1,1,2,10,8,18
08/13/2019,Brooklyn,McCarren,Night Owl,5,4,9,44,26,70
08/13/2019,Manhattan,Tony Dapolito,Night Owl,2,0,2,13,5,18
08/13/2019,Manhattan,Marcus Garvey,Night Owl,0,0,0,1,5,6
08/13/2019,Manhattan,Asser Levy,Night Owl,1,2,3,7,11,18
08/13/2019,Manhattan,Lasker,Night Owl,3,5,8,16,18,34
08/13/2019,Manhattan,John Jay,Night Owl,2,3,5,22,17,39
08/13/2019,Manhattan,Hamilton Fish,Night Owl,5,0,5,22,17,39
08/12/2019,Staten Island,Lyons,Night Owl,0,1,1,12,15,27
08/12/2019,Queens,Astoria,Night Owl,10,10,20,43,37,80
08/12/2019,Bronx,Crotona,Night Owl,0,0,0,2,2,4
08/12/2019,Bronx,Van Cortlandt,Night Owl,1,2,3,9,20,29
08/12/2019,Brooklyn,Sunset,Night Owl,1,4,5,24,27,51
08/12/2019,Brooklyn,Red Hook,Night Owl,4,3,7,22,15,37
08/12/2019,Brooklyn,McCarren,Night Owl,9,11,20,75,85,160
08/12/2019,Manhattan,Tony Dapolito,Night Owl,2,1,3,9,12,21
08/12/2019,Manhattan,Marcus Garvey,Night Owl,3,2,5,8,12,20
08/12/2019,Manhattan,Asser Levy,Night Owl,2,1,3,18,14,32
08/12/2019,Manhattan,Lasker,Night Owl,9,9,18,35,41,76
08/12/2019,Manhattan,John Jay,Night Owl,3,4,7,41,40,81
08/12/2019,Manhattan,Hamilton Fish,Night Owl,1,9,10,39,31,70
08/09/2019,Staten Island,Lyons,Night Owl,0,0,0,6,5,11
08/09/2019,Queens,Astoria,Night Owl,5,4,9,35,35,70
08/09/2019,Bronx,Crotona,Night Owl,0,0,0,2,1,3
08/09/2019,Bronx,Van Cortlandt,Night Owl,1,1,2,19,14,33
08/09/2019,Brooklyn,Sunset,Night Owl,7,5,12,28,19,47
08/09/2019,Brooklyn,Red Hook,Night Owl,0,0,0,0,0,0
08/09/2019,Brooklyn,McCarren,Night Owl,4,10,14,35,37,72
08/09/2019,Manhattan,Tony Dapolito,Night Owl,0,1,1,8,7,15
08/09/2019,Manhattan,Marcus Garvey,Night Owl,1,0,1,9,9,18
08/09/2019,Manhattan,Asser Levy,Night Owl,1,1,2,6,9,15
08/09/2019,Manhattan,Lasker,Night Owl,0,2,2,23,27,50
08/09/2019,Manhattan,John Jay,Night Owl,4,5,9,30,31,61
08/09/2019,Manhattan,Hamilton Fish,Night Owl,2,3,5,21,20,41
08/08/2019,Staten Island,Lyons,Night Owl,0,0,0,7,16,23
08/08/2019,Queens,Astoria,Night Owl,6,5,11,37,37,74
08/08/2019,Bronx,Crotona,Night Owl,0,0,0,3,1,4
08/08/2019,Bronx,Van Cortlandt,Night Owl,5,3,8,10,23,33
08/08/2019,Brooklyn,Sunset,Night Owl,1,1,2,22,21,43
08/08/2019,Brooklyn,Red Hook,Night Owl,2,2,4,18,17,35
08/08/2019,Brooklyn,McCarren,Night Owl,4,9,13,49,51,100
08/08/2019,Manhattan,Tony Dapolito,Night Owl,0,1,1,12,8,20
08/08/2019,Manhattan,Marcus Garvey,Night Owl,0,0,0,9,14,23
08/08/2019,Manhattan,Marcus Garvey,Night Owl,0,0,0,9,14,23
08/08/2019,Manhattan,Asser Levy,Night Owl,2,1,3,15,13,28
08/08/2019,Manhattan,Lasker,Night Owl,3,1,4,26,27,53
08/08/2019,Manhattan,John Jay,Night Owl,3,6,9,27,38,65
08/08/2019,Manhattan,Hamilton Fish,Night Owl,9,5,14,42,22,64
08/07/2019,Staten Island,Lyons,Night Owl,0,0,0,0,0,0
08/07/2019,Queens,Astoria,Night Owl,0,0,0,0,0,0
08/07/2019,Bronx,Crotona,Night Owl,0,0,0,0,0,0
08/07/2019,Bronx,Van Cortlandt,Night Owl,0,0,0,0,0,0
08/07/2019,Brooklyn,Sunset,Night Owl,0,0,0,0,0,0
08/07/2019,Brooklyn,Red Hook,Night Owl,0,0,0,0,0,0
08/07/2019,Brooklyn,McCarren,Night Owl,0,0,0,0,0,0
08/07/2019,Manhattan,Tony Dapolito,Night Owl,1,0,1,1,0,1
08/07/2019,Manhattan,Marcus Garvey,Night Owl,0,0,0,0,0,0
08/07/2019,Manhattan,Asser Levy,Night Owl,0,0,0,1,1,2
08/07/2019,Manhattan,Lasker,Night Owl,0,0,0,0,0,0
08/07/2019,Manhattan,John Jay,Night Owl,0,0,0,0,0,0
08/07/2019,Manhattan,Hamilton Fish,Night Owl,0,0,0,0,0,0
08/06/2019,Staten Island,Crotona,Night Owl,0,2,2,6,17,23
08/06/2019,Queens,Astoria,Night Owl,10,4,14,45,34,79
08/06/2019,Bronx,Crotona,Night Owl,1,2,3,5,4,9
08/06/2019,Bronx,Van Cortlandt,Night Owl,1,2,3,10,16,26
08/06/2019,Brooklyn,Sunset,Night Owl,3,4,7,33,21,54
08/06/2019,Brooklyn,Red Hook,Night Owl,0,0,0,0,0,0
08/06/2019,Brooklyn,McCarren,Night Owl,11,6,17,66,46,112
08/06/2019,Manhattan,Tony Dapolito,Night Owl,4,1,5,10,14,24
08/06/2019,Manhattan,Marcus Garvey,Night Owl,2,3,5,9,15,24
08/06/2019,Manhattan,Asser Levy,Night Owl,2,2,4,16,19,35
08/06/2019,Manhattan,Lasker,Night Owl,5,8,13,26,29,55
08/06/2019,Manhattan,John Jay,Night Owl,2,6,8,26,29,55
08/06/2019,Manhattan,Hamilton Fish,Night Owl,10,4,14,27,41,68
08/05/2019,Staten Island,Lyons,Night Owl,0,3,3,10,16,26
08/05/2019,Queens,Astoria,Night Owl,5,9,14,38,46,84
08/05/2019,Bronx,Crotona,Night Owl,2,0,2,7,2,9
08/05/2019,Bronx,Van Cortlandt,Night Owl,1,0,1,8,13,21
08/05/2019,Brooklyn,Sunset,Night Owl,0,0,0,0,0,0
08/05/2019,Brooklyn,Red Hook,Night Owl,0,0,0,0,0,0
08/05/2019,Brooklyn,McCarren,Night Owl,9,12,21,48,38,86
08/05/2019,Manhattan,Tony Dapolito,Night Owl,0,3,3,6,10,16
08/05/2019,Manhattan,Marcus Garvey,Night Owl,2,2,4,6,14,20
08/05/2019,Manhattan,Asser Levy,Night Owl,0,3,3,14,14,28
08/05/2019,Manhattan,Lasker,Night Owl,8,8,16,44,41,85
08/05/2019,Manhattan,John Jay,Night Owl,6,10,16,39,46,85
08/05/2019,Manhattan,Hamilton Fish,Night Owl,5,3,8,51,26,77
08/02/2019,Staten Island,Lyons,Night Owl,1,0,1,9,14,23
08/02/2019,Queens,Astoria,Night Owl,5,6,11,30,35,65
08/02/2019,Bronx,Crotona,Night Owl,0,1,1,2,1,3
08/02/2019,Bronx,Van Cortlandt,Night Owl,2,0,2,13,13,26
08/02/2019,Brooklyn,Sunset,Night Owl,5,5,10,26,25,51
08/02/2019,Brooklyn,Red Hook,Night Owl,1,5,6,16,16,32
08/02/2019,Brooklyn,McCarren,Night Owl,5,17,22,32,61,93
08/02/2019,Manhattan,Tony Dapolito,Night Owl,1,0,1,10,7,17
08/02/2019,Manhattan,Marcus Garvey,Night Owl,0,0,0,6,7,13
08/02/2019,Manhattan,Asser Levy,Night Owl,0,3,3,14,14,28
08/02/2019,Manhattan,Lasker,Night Owl,7,8,15,41,38,79
08/02/2019,Manhattan,John Jay,Night Owl,7,6,13,26,35,61
08/02/2019,Manhattan,Hamilton Fish,Night Owl,9,7,16,43,32,75
08/01/2019,Staten Island,Lyons,Night Owl,0,2,2,8,10,18
08/01/2019,Queens,Astoria,Night Owl,6,13,19,37,59,96
08/01/2019,Bronx,Crotona,Night Owl,1,1,2,9,3,12
08/01/2019,Bronx,Van Cortlandt,Night Owl,7,1,8,17,22,39
08/01/2019,Brooklyn,Sunset,Night Owl,5,4,9,31,29,60
08/01/2019,Brooklyn,Red Hook,Night Owl,4,5,9,23,33,56
08/01/2019,Brooklyn,McCarren,Night Owl,8,11,19,63,59,122
08/01/2019,Manhattan,Tony Dapolito,Night Owl,3,4,7,14,12,26
08/01/2019,Manhattan,Marcus Garvey,Night Owl,1,0,1,8,13,21
08/01/2019,Manhattan,Asser Levy,Night Owl,2,4,6,17,20,37
08/01/2019,Manhattan,Lasker,Night Owl,3,6,9,33,37,70
08/01/2019,Manhattan,John Jay,Night Owl,3,8,11,37,45,82
08/01/2019,Manhattan,Hamilton Fish,Night Owl,10,5,15,42,35,77
07/31/2019,Staten Island,Lyons,Night Owl,0,0,0,7,2,9
07/31/2019,Queens,Astoria,Night Owl,1,5,6,17,16,33
07/31/2019,Bronx,Crotona,Night Owl,0,0,0,2,0,2
07/31/2019,Bronx,Van Cortlandt,Night Owl,0,1,1,3,5,8
07/31/2019,Brooklyn,Sunset,Night Owl,0,0,0,12,4,16
07/31/2019,Brooklyn,Red Hook,Night Owl,2,0,2,15,9,24
07/31/2019,Brooklyn,McCarren,Night Owl,5,3,8,22,18,40
07/31/2019,Manhattan,Tony Dapolito,Night Owl,0,1,1,4,3,7
07/31/2019,Manhattan,Marcus Garvey,Night Owl,1,0,1,3,2,5
07/31/2019,Manhattan,Asser Levy,Night Owl,1,0,1,13,19,32
07/31/2019,Manhattan,Lasker,Night Owl,3,2,5,13,11,24
07/31/2019,Manhattan,John Jay,Night Owl,7,3,10,15,12,27
07/31/2019,Manhattan,Hamilton Fish,Night Owl,2,0,2,24,13,37
07/30/2019,Staten Island,Lyons,Night Owl,0,2,2,10,19,29
07/30/2019,Queens,Astoria,Night Owl,7,21,28,46,59,105
07/30/2019,Bronx,Crotona,Night Owl,1,0,1,1,1,2
07/30/2019,Bronx,Van Cortlandt,Night Owl,2,3,5,15,21,36
07/30/2019,Brooklyn,Sunset,Night Owl,4,6,10,29,41,70
07/30/2019,Brooklyn,Red Hook,Night Owl,7,13,20,38,49,87
07/30/2019,Brooklyn,McCarren,Night Owl,11,26,37,66,86,152
07/30/2019,Manhattan,Tony Dapolito,Night Owl,1,3,4,11,16,27
07/30/2019,Manhattan,Marcus Garvey,Night Owl,3,9,12,7,25,32
07/30/2019,Manhattan,Asser Levy,Night Owl,2,3,5,20,22,42
07/30/2019,Manhattan,Lasker,Night Owl,18,25,43,47,71,118
07/30/2019,Manhattan,John Jay,Night Owl,9,12,21,48,48,96
07/30/2019,Manhattan,Hamilton Fish,Night Owl,6,5,11,46,29,75
07/29/2019,Staten Island,Lyons,Night Owl,3,1,4,13,15,28
07/29/2029,Queens,Astoria,Night Owl,8,24,32,48,70,118
07/29/2019,Bronx,Crotona,Night Owl,0,0,0,3,1,4
07/29/2019,Bronx,Van Cortlandt,Night Owl,7,9,16,12,25,37
07/29/2019,Brooklyn,Sunset,Night Owl,13,10,23,40,41,81
07/29/2019,Brooklyn,Red Hook,Night Owl,7,8,15,27,28,55
07/29/2019,Brooklyn,McCarren,Night Owl,25,33,58,84,84,168
07/29/2019,Manhattan,Tony Dapolito,Night Owl,3,6,9,17,19,36
07/29/2019,Manhattan,Marcus Garvey,Night Owl,2,5,7,11,20,31
07/29/2019,Manhattan,Asser Levy,Night Owl,3,2,5,20,21,41
07/29/2019,Manhattan,Lasker,Night Owl,20,25,45,58,59,117
07/29/2019,Manhattan,John Jay,Night Owl,9,12,21,50,54,104
07/29/2019,Manhattan,Hamilton Fish,Night Owl,10,10,20,51,35,86
07/26/2019,Staten Island,Lyons,Night Owl,0,0,0,8,9,17
07/26/2019,Queens,Astoria,Night Owl,13,14,27,38,38,76
07/26/2019,Bronx,Crotona,Night Owl,2,0,2,4,1,5
07/26/2019,Bronx,Van Cortlandt,Night Owl,2,4,6,7,16,23
07/26/2019,Brooklyn,Sunset,Night Owl,2,8,10,25,26,51
07/26/2019,Brooklyn,Red Hook,Night Owl,5,8,13,23,23,46
07/26/2019,Brooklyn,McCarren,Night Owl,13,13,26,52,45,97
07/26/2019,Manhattan,Tony Dapolito,Night Owl,0,2,2,10,9,19
07/26/2019,Manhattan,Marcus Garvey,Night Owl,2,0,2,9,16,25
07/26/2019,Manhattan,Asser Levy,Night Owl,1,4,5,19,17,36
07/26/2019,Manhattan,Lasker,Night Owl,4,13,17,34,39,73
07/26/2019,Manhattan,John Jay,Night Owl,4,11,15,28,28,56
07/26/2019,Manhattan,Hamilton Fish,Night Owl,8,9,17,47,41,88
07/25/2019,Staten Island,Lyons,Night Owl,2,3,5,10,14,24
07/25/2019,Queens,Astoria,Night Owl,16,14,30,45,60,105
07/25/2019,Bronx,Crotona,Night Owl,2,4,6,4,5,9
07/25/2019,Bronx,Van Cortlandt,Night Owl,4,4,8,15,19,34
07/25/2019,Brooklyn,Sunset,Night Owl,0,0,0,0,0,0
07/25/2019,Brooklyn,Red Hook,Night Owl,6,7,13,22,18,40
07/25/2019,Brooklyn,McCarren,Night Owl,13,22,35,54,57,111
07/25/2019,Manhattan,Tony Dapolito,Night Owl,1,4,5,7,17,24
07/25/2019,Manhattan,Marcus Garvey,Night Owl,2,3,5,11,13,24
07/25/2019,Manhattan,Asser Levy,Night Owl,3,8,11,19,19,38
07/25/2019,Manhattan,Lasker,Night Owl,9,7,16,38,35,73
07/25/2019,Manhattan,John Jay,Night Owl,9,16,25,31,42,73
07/25/2019,Manhattan,Hamilton Fish,Night Owl,9,7,16,51,37,88
07/24/2019,Staten Island,Lyons,Night Owl,0,2,2,8,10,18
07/24/2019,Queens,Astoria,Night Owl,16,18,34,46,54,100
07/24/2019,Bronx,Crotona,Night Owl,0,0,0,2,0,2
07/24/2019,Bronx,Van Cortlandt,Night Owl,3,1,4,15,15,30
07/24/2019,Brooklyn,Sunset,Night Owl,5,6,11,28,34,62
07/24/2019,Brooklyn,Red Hook,Night Owl,6,10,16,21,27,48
07/24/2019,Brooklyn,McCarren,Night Owl,14,16,30,70,78,148
07/24/2019,Manhattan,Tony Dapolito,Night Owl,1,2,3,8,11,19
07/24/2019,Manhattan,Marcus Garvey,Night Owl,0,3,3,8,18,26
07/24/2019,Manhattan,Asser Levy,Night Owl,3,21,24,18,39,57
07/24/2019,Manhattan,Lasker,Night Owl,8,17,25,29,43,72
07/24/2019,Manhattan,John Jay,Night Owl,10,15,25,34,45,79
07/24/2019,Manhattan,Hamilton Fish,Night Owl,13,17,30,59,42,101
07/23/2019,Staten Island,Lyons,Night Owl,0,0,0,5,6,11
07/23/2019,Queens,Astoria,Night Owl,6,5,11,22,18,40
07/23/2019,Bronx,Crotona,Night Owl,0,0,0,4,1,5
07/23/2019,Bronx,Van Cortlandt,Night Owl,2,3,5,7,12,19
07/23/2019,Brooklyn,Red Hook,Night Owl,4,3,7,21,18,39
07/23/2019,Brooklyn,Red Hook,Night Owl,0,1,1,10,16,26
07/23/2019,Brooklyn,McCarren,Night Owl,8,5,13,36,20,56
07/23/2019,Manhattan,Tony Dapolito,Night Owl,2,0,2,9,8,17
07/23/2019,Manhattan,Marcus Garvey,Night Owl,1,2,3,8,4,12
07/23/2019,Manhattan,Asser Levy,Night Owl,1,1,2,8,4,12
07/23/2019,Manhattan,Lasker,Night Owl,2,2,4,18,15,33
07/23/2019,Manhattan,John Jay,Night Owl,12,14,26,28,17,45
07/23/2019,Manhattan,Hamilton Fish,Night Owl,6,3,9,38,17,55
07/22/2019,Staten Island,Lyons,Night Owl,0,0,0,0,0,0
07/22/2019,Queens,Astoria,Night Owl,0,1,1,0,0,0
07/22/2019,Bronx,Crotona,Night Owl,0,0,0,0,0,0
07/22/2019,Bronx,Van Cortlandt,Night Owl,0,0,0,0,0,0
07/22/2019,Brooklyn,Sunset,Night Owl,0,0,0,0,0,0
07/22/2019,Brooklyn,McCarren,Night Owl,0,0,0,0,0,0
07/22/2019,Brooklyn,McCarren,Night Owl,0,0,0,0,0,0
07/22/2019,Manhattan,Tony Dapolito,Night Owl,0,0,0,0,0,0
07/22/2019,Manhattan,Asser Levy,Night Owl,0,0,0,0,0,0
07/22/2019,Manhattan,Marcus Garvey,Night Owl,0,0,0,0,0,0
07/22/2019,Manhattan,Asser Levy,Night Owl,0,0,0,0,0,0
07/22/2019,Manhattan,Lasker,Night Owl,0,0,0,0,0,0
07/22/2019,Manhattan,Lasker,Night Owl,0,0,0,0,0,0
07/22/2019,Manhattan,John Jay,Night Owl,0,0,0,0,0,0
07/22/2019,Manhattan,Hamilton Fish,Night Owl,0,0,0,0,0,0
07/19/2019,Staten Island,Lyons,Night Owl,0,0,0,0,0,0
07/19/2019,Queens,Astoria,Night Owl,1,3,4,0,0,0
07/19/2019,Bronx,Crotona,Night Owl,0,1,1,0,,0
07/19/2019,Bronx,Van Cortlandt,Night Owl,0,0,0,0,0,0
07/19/2019,Brooklyn,Sunset,Night Owl,0,0,0,0,0,0
07/19/2019,Brooklyn,Red Hook,Night Owl,0,0,0,0,0,0
07/19/2019,Brooklyn,McCarren,Night Owl,0,0,0,0,0,0
07/19/2019,Manhattan,Tony Dapolito,Night Owl,0,0,0,0,0,0
07/19/2019,Manhattan,Marcus Garvey,Night Owl,0,0,0,0,0,0
07/19/2019,Manhattan,Asser Levy,Night Owl,0,0,0,0,0,0
07/19/2019,Manhattan,Lasker,Night Owl,0,0,0,0,0,0
07/19/2019,Manhattan,John Jay,Night Owl,0,0,0,0,0,0
07/19/2019,Manhattan,Hamilton Fish,Night Owl,0,0,0,0,0,0
07/18/2019,Staten Island,Lyons,Night Owl,0,1,1,4,2,6
07/18/2819,Queens,Astoria,Night Owl,4,2,6,23,11,34
07/18/2019,Bronx,Crotona,Night Owl,0,0,0,2,0,2
07/18/2019,Bronx,Van Cortlandt,Night Owl,0,2,2,6,17,23
07/18/2019,Brooklyn,Sunset,Night Owl,3,3,6,13,25,38
07/18/2019,Brooklyn,Red Hook,Night Owl,0,1,1,5,6,11
07/18/2019,Brooklyn,McCarren,Night Owl,6,4,10,32,28,60
07/18/2019,Manhattan,Tony Dapolito,Night Owl,1,28,29,6,,6
07/18/2019,Manhattan,Marcus Garvey,Night Owl,0,0,0,6,7,13
07/18/2019,Manhattan,Asser Levy,Night Owl,3,3,6,16,12,28
07/18/2019,Manhattan,Lasker,Night Owl,5,1,6,22,15,37
07/18/2019,Manhattan,John Jay,Night Owl,5,7,12,17,16,33
07/18/2019,Manhattan,Hamilton Fish,Night Owl,4,2,6,22,15,37
07/17/2019,Staten Island,Lyons,Night Owl,0,7,7,6,19,25
07/17/2019,Queens,Astoria,Night Owl,0,0,0,0,0,0
07/17/2019,Bronx,Crotona,Night Owl,0,7,7,5,18,23
07/17/2019,Bronx,Van Cortlandt,Night Owl,2,2,4,6,11,17
07/17/2019,Brooklyn,Sunset,Night Owl,2,11,13,23,24,47
07/17/2019,Brooklyn,Red Hook,Night Owl,3,4,7,16,16,32
07/17/2019,Brooklyn,McCarren,Night Owl,10,17,27,44,51,95
07/17/2019,Manhattan,Tony Dapolito,Night Owl,2,6,8,10,13,23
07/17/2019,Manhattan,Marcus Garvey,Night Owl,6,6,12,8,13,21
07/17/2019,Manhattan,Asser Levy,Night Owl,9,2,11,20,16,36
07/17/2019,Manhattan,Lasker,Night Owl,5,10,15,27,25,52
07/17/2019,Manhattan,John Jay,Early Bird,8,16,24,35,42,77
07/17/2019,Manhattan,Hamilton Fish,Night Owl,15,12,27,41,45,86
07/16/2019,Staten Island,Lyons,Night Owl,0,0,0,0,0,0
07/16/2019,Queens,Astoria,Night Owl,13,15,28,13,15,28
07/16/2019,Bronx,Crotona,Night Owl,2,2,4,6,5,11
07/16/2019,Bronx,Van Cortlandt,Night Owl,5,8,13,10,30,40
07/16/2019,Brooklyn,Sunset,Night Owl,14,20,34,46,48,94
07/16/2019,Brooklyn,Red Hook,Night Owl,13,15,28,30,29,59
07/16/2019,Brooklyn,McCarren,Night Owl,32,53,85,98,106,204
07/16/2019,Manhattan,Tony Dapolito,Night Owl,3,4,7,13,14,27
07/16/2019,Manhattan,Marcus Garvey,Night Owl,5,9,14,13,26,39
07/16/2019,Manhattan,Asser Levy,Night Owl,10,9,19,31,24,55
07/16/2019,Manhattan,Lasker,Night Owl,6,22,28,22,66,88
07/16/2019,Manhattan,John Jay,Night Owl,19,34,53,51,77,128
07/16/2019,Manhattan,Hamilton Fish,Night Owl,18,24,42,53,58,111
07/15/2019,Staten Island,Lyons,Night Owl,4,4,8,15,15,30
07/15/2019,Queens,Astoria,Night Owl,26,37,63,74,82,156
07/15/2019,Bronx,Crotona,Night Owl,0,0,0,3,1,4
07/15/2019,Bronx,Van Cortlandt,Night Owl,4,3,7,14,9,23
07/15/2019,Brooklyn,Sunset,Night Owl,13,24,37,36,49,85
07/15/2019,Brooklyn,Red Hook,Night Owl,10,15,25,34,37,71
07/15/2019,Brooklyn,McCarren,Night Owl,43,53,96,98,116,214
07/15/2019,Manhattan,Tony Dapolito,Night Owl,13,8,21,23,20,43
07/15/2019,Manhattan,Marcus Garvey,Night Owl,4,9,13,13,20,33
07/15/2019,Manhattan,Asser Levy,Night Owl,5,5,10,24,21,45
07/15/2019,Manhattan,Lasker,Night Owl,17,28,45,42,48,90
07/15/2019,Manhattan,John Jay,Night Owl,24,34,58,38,51,89
07/15/2019,Manhattan,Hamilton Fish,Night Owl,33,36,69,58,79,137
07/15/2019,Manhattan,Hamilton Fish,Night Owl,33,36,69,21,58,79
07/12/2019,Staten Island,Lyons,Night Owl,6,5,11,13,21,34
07/12/2019,Queens,Astoria,Night Owl,14,25,39,55,79,134
07/12/2019,Bronx,Crotona,Night Owl,0,0,0,2,1,3
07/12/2019,Bronx,Van Cortlandt,Night Owl,6,6,12,18,16,34
07/12/2019,Brooklyn,Sunset,Night Owl,3,9,12,26,30,56
07/12/2019,Brooklyn,Red Hook,Night Owl,9,11,20,24,35,59
07/12/2019,Brooklyn,McCarren,Night Owl,35,39,74,74,82,156
07/11/2019,Manhattan,Tony Dapolito,Night Owl,7,6,13,16,14,30
07/11/2019,Manhattan,Marcus Garvey,Night Owl,4,2,6,11,16,27
07/11/2019,Manhattan,Asser Levy,Night Owl,3,9,12,13,15,28
07/11/2019,Manhattan,Lasker,Night Owl,11,11,22,38,42,80
07/12/2019,Manhattan,John Jay,Night Owl,4,10,14,41,45,86
07/12/2019,Manhattan,Hamilton Fish,Night Owl,17,18,35,45,41,86
07/11/2019,Staten Island,Lyons,Night Owl,0,0,0,0,0,0
07/11/2019,Queens,Astoria,Night Owl,3,1,4,9,6,15
07/11/2019,Bronx,Crotona,Night Owl,0,0,0,0,0,0
07/11/2019,Bronx,Van Cortlandt,Night Owl,0,0,0,2,1,3
07/11/2019,Brooklyn,Sunset,Night Owl,1,0,1,9,1,10
07/11/2019,Brooklyn,Red Hook,Night Owl,2,2,4,7,4,11
07/11/2019,Brooklyn,McCarren,Night Owl,5,4,9,13,14,27
07/11/2019,Manhattan,Tony Dapolito,Night Owl,1,0,1,5,1,6
07/11/2019,Manhattan,Marcus Garvey,Night Owl,4,1,5,5,2,7
07/11/2019,Manhattan,Asser Levy,Night Owl,0,0,0,3,5,8
07/11/2019,Manhattan,Lasker,Night Owl,1,1,2,4,3,7
07/11/2019,Manhattan,John Jay,Night Owl,11,13,24,10,6,16
07/11/2019,Manhattan,Hamilton Fish,Night Owl,5,4,9,14,11,25
07/10/2019,Staten Island,Lyons,Night Owl,4,8,12,14,15,29
07/10/2019,Queens,Astoria,Night Owl,28,25,53,62,59,121
07/10/2019,Bronx,Crotona,Night Owl,1,3,4,5,5,10
07/10/2019,Bronx,Van Cortlandt,Night Owl,6,9,15,13,27,40
07/10/2019,Brooklyn,Sunset,Night Owl,6,17,23,25,41,66
07/10/2019,Brooklyn,Red Hook,Night Owl,16,16,32,24,25,49
07/10/2019,Brooklyn,McCarren,Night Owl,35,49,84,72,77,149
07/10/2019,Manhattan,Tony Dapolito,Night Owl,5,7,12,11,16,27
07/10/2019,Manhattan,Marcus Garvey,Night Owl,5,8,13,8,18,26
07/10/2019,Manhattan,Asser Levy,Night Owl,5,12,17,15,29,44
07/10/2019,Manhattan,Lasker,Night Owl,25,24,49,45,52,97
07/10/2019,Manhattan,John Jay,Night Owl,29,37,66,44,46,90
07/10/2019,Manhattan,Hamilton Fish,Night Owl,16,28,44,50,47,97
07/09/2019,Staten Island,Lyons,Night Owl,3,13,16,11,18,29
07/09/2019,Queens,Astoria,Night Owl,35,40,75,55,67,122
07/09/2019,Bronx,Crotona,Night Owl,4,14,18,4,14,18
07/09/2019,Brooklyn,Sunset,Night Owl,15,25,40,44,35,79
07/09/2019,Bronx,Van Cortlandt,Night Owl,10,21,31,15,33,48
07/09/2019,Brooklyn,Red Hook,Night Owl,28,33,61,36,40,76
07/09/2019,Brooklyn,McCarren,Early Bird,56,69,125,87,92,179
07/09/2019,Manhattan,Tony Dapolito,Night Owl,10,19,29,17,27,44
07/09/2019,Manhattan,Marcus Garvey,Night Owl,8,15,23,12,22,34
07/09/2019,Manhattan,Asser Levy,Night Owl,16,23,39,23,29,52
07/09/2019,Manhattan,Lasker,Night Owl,26,45,71,63,50,113
07/09/2019,Manhattan,John Jay,Night Owl,43,43,86,53,58,111
07/09/2019,Manhattan,Hamilton Fish,Night Owl,23,36,59,45,49,94
07/08/2019,Staten Island,Lyons,Night Owl,7,7,14,12,15,27
07/08/2019,Queens,Astoria,Night Owl,37,53,90,52,72,124
07/08/2019,Bronx,Crotona,Night Owl,2,1,3,3,6,9
07/08/2019,Bronx,Van Cortlandt,Night Owl,10,22,32,16,26,42
07/08/2019,Brooklyn,Sunset,Night Owl,28,43,71,37,51,88
07/08/2019,Brooklyn,Red Hook,Night Owl,10,21,31,20,27,47
07/08/2019,Brooklyn,McCarren,Night Owl,57,57,114,72,76,148
07/08/2019,Manhattan,Tony Dapolito,Night Owl,10,8,18,13,12,25
07/08/2019,Manhattan,Marcus Garvey,Night Owl,8,14,22,10,19,29
07/08/2019,Manhattan,Asser Levy,Night Owl,11,10,21,15,19,34
07/08/2019,Manhattan,Lasker,Night Owl,25,32,57,34,42,76
07/08/2019,Manhattan,John Jay,Night Owl,56,46,102,61,46,107
07/08/2019,Manhattan,Hamilton Fish,Night Owl,34,24,58,58,34,92
07/05/2019,Staten Island,Lyons,Night Owl,13,11,24,12,10,22
07/05/2019,Queens,Astoria,Night Owl,64,75,139,49,75,124
07/05/2019,Bronx,Crotona,Night Owl,3,4,7,3,4,7
07/05/2019,Bronx,Van Cortlandt,Night Owl,7,16,23,8,16,24
07/05/2019,Brooklyn,Sunset,Night Owl,27,37,64,27,37,64
07/05/2019,Brooklyn,Red Hook,Night Owl,23,21,44,23,21,44
07/05/2019,Brooklyn,McCarren,Night Owl,46,64,110,42,64,106
07/05/2019,Manhattan,Tony Dapolito,Night Owl,5,10,15,5,10,15
07/05/2019,Manhattan,Marcus Garvey,Night Owl,5,12,17,3,8,11
07/05/2019,Manhattan,Asser Levy,Night Owl,11,15,26,12,25,37
07/05/2019,Manhattan,Lasker,Night Owl,21,23,44,41,51,92
07/05/2019,Manhattan,John Jay,Night Owl,28,41,69,27,46,73
07/05/2019,Manhattan,Hamilton Fish,Night Owl,30,30,60,38,30,68
08/30/2019,Staten Island,Lyons,Early Bird,0,0,0,8,9,17
08/30/2019,Queens,Astoria,Early Bird,0,0,0,21,28,49
08/30/2019,Bronx,Crotona,Early Bird,0,0,0,2,2,4
08/30/2019,Bronx,Van Cortlandt,Early Bird,0,0,0,20,15,35
08/30/2019,Brooklyn,Kosciuszko,Early Bird,0,1,1,7,5,12
08/30/2019,Brooklyn,Red Hook,Early Bird,0,0,0,15,29,44
08/30/2019,Brooklyn,Sunset,Early Bird,0,0,0,26,32,58
08/30/2019,Brooklyn,McCarren,Early Bird,0,0,0,68,72,140
08/30/2019,Manhattan,Thomas Jefferson,Early Bird,0,0,0,8,7,15
08/30/2019,Manhattan,Tony Dapolito,Early Bird,0,0,0,13,22,35
08/30/2019,Manhattan,Jackie Robinson,Early Bird,0,0,0,11,20,31
08/30/2019,Manhattan,Asser Levy,Early Bird,0,0,0,19,23,42
08/30/2019,Manhattan,Lasker,Early Bird,0,5,5,27,1,28
08/30/2019,Manhattan,Hamilton Fish,Early Bird,0,0,0,22,30,52
08/30/2019,Manhattan,John Jay,Early Bird,0,0,0,30,40,70
08/29/2019,Staten Island,Lyons,Early Bird,0,0,0,7,8,15
08/29/2019,Queens,Astoria,Early Bird,1,0,1,36,34,70
08/29/2019,Bronx,Crotona,Early Bird,0,0,0,1,1,2
08/29/2019,Bronx,Van Cortlandt,Early Bird,0,0,0,18,10,28
08/29/2019,Brooklyn,Kosciuszko,Early Bird,2,0,2,12,6,18
08/29/2019,Brooklyn,Red Hook,Early Bird,0,1,1,16,22,38
08/29/2019,Brooklyn,Sunset,Early Bird,1,0,1,23,27,50
08/29/2019,Brooklyn,McCarren,Early Bird,1,2,3,49,58,107
08/29/2019,Manhattan,Thomas Jefferson,Early Bird,0,0,0,11,7,18
08/29/2019,Manhattan,Tony Dapolito,Early Bird,0,0,0,10,14,24
08/29/2019,Manhattan,Jackie Robinson,Early Bird,1,1,2,9,25,34
08/29/2019,Manhattan,Asser Levy,Early Bird,0,0,0,11,22,33
08/29/2019,Manhattan,John Jay,Early Bird,1,1,2,32,30,62
08/29/2019,Manhattan,Lasker,Early Bird,0,0,0,23,33,56
08/29/2019,Manhattan,Hamilton Fish,Early Bird,0,0,0,16,20,36
08/28/2019,Staten Island,Lyons,Early Bird,0,0,0,7,6,13
08/28/2019,Queens,Astoria,Early Bird,1,0,1,33,37,70
08/28/2019,Bronx,Crotona,Early Bird,0,0,0,0,1,1
08/28/2019,Bronx,Van Cortlandt,Early Bird,0,0,0,17,17,34
08/28/2019,Brooklyn,Kosciuszko,Early Bird,1,0,1,7,6,13
08/28/2019,Brooklyn,Red Hook,Early Bird,0,0,0,18,21,39
08/28/2019,Brooklyn,Sunset,Early Bird,1,0,1,22,26,48
08/28/2019,Brooklyn,McCarren,Early Bird,3,2,5,57,44,101
08/28/2019,Manhattan,Thomas Jefferson,Early Bird,0,0,0,9,9,18
08/28/2019,Manhattan,Tony Dapolito,Early Bird,0,0,0,7,12,19
08/28/2019,Manhattan,Jackie Robinson,Early Bird,0,0,0,8,16,24
08/28/2019,Manhattan,Asser Levy,Early Bird,0,0,0,18,24,42
08/28/2019,Manhattan,John Jay,Early Bird,2,1,3,18,33,51
08/28/2019,Manhattan,Lasker,Early Bird,1,1,2,22,34,56
08/28/2019,Manhattan,Hamilton Fish,Early Bird,0,0,0,29,32,61
08/27/2019,Staten Island,Lyons,Early Bird,0,0,0,4,6,10
08/27/2019,Queens,Astoria,Early Bird,1,1,2,34,33,67
08/27/2019,Bronx,Crotona,Early Bird,0,0,0,2,1,3
08/27/2019,Bronx,Van Cortlandt,Early Bird,0,0,0,15,7,22
08/27/2019,Brooklyn,Kosciuszko,Early Bird,0,0,0,8,25,33
08/27/2019,Brooklyn,Red Hook,Early Bird,1,0,1,15,14,29
08/27/2019,Brooklyn,Sunset,Early Bird,0,0,0,19,24,43
08/27/2019,Brooklyn,McCarren,Early Bird,1,4,5,46,59,105
08/27/2019,Manhattan,Thomas Jefferson,Early Bird,1,0,1,8,8,16
08/27/2019,Manhattan,Tony Dapolito,Early Bird,0,1,1,8,14,22
08/27/2019,Manhattan,Jackie Robinson,Early Bird,1,0,1,6,17,23
08/27/2019,Manhattan,Asser Levy,Early Bird,1,0,1,14,15,29
08/27/2019,Manhattan,John Jay,Early Bird,1,0,1,27,24,51
08/27/2019,Manhattan,Lasker,Early Bird,0,0,0,19,35,54
08/27/2019,Manhattan,Hamilton Fish,Early Bird,0,0,0,26,28,54
08/26/2019,Staten Island,Lyons,Early Bird,0,0,0,4,3,7
08/26/2019,Manhattan,Astoria,Early Bird,0,1,1,29,31,60
08/26/2019,Bronx,Crotona,Early Bird,0,0,0,1,3,4
08/26/2019,Bronx,Van Cortlandt,Early Bird,0,0,0,19,8,27
08/26/2019,Brooklyn,Kosciuszko,Early Bird,0,1,1,5,8,13
08/26/2019,Brooklyn,Red Hook,Early Bird,2,0,2,16,12,28
08/26/2019,Brooklyn,Sunset,Early Bird,0,2,2,16,25,41
08/26/2019,Brooklyn,McCarren,Early Bird,1,1,2,38,29,67
08/26/2019,Manhattan,Thomas Jefferson,Early Bird,1,2,3,10,7,17
08/26/2019,Manhattan,Tony Dapolito,Early Bird,0,0,0,5,11,16
08/26/2019,Manhattan,Jackie Robinson,Early Bird,0,0,0,7,16,23
08/26/2019,Manhattan,Asser Levy,Early Bird,0,2,2,16,17,33
08/26/2019,Manhattan,John Jay,Early Bird,2,2,4,20,25,45
08/26/2019,Manhattan,Lasker,Early Bird,2,0,2,15,22,37
08/26/2019,Manhattan,Hamilton Fish,Early Bird,1,0,1,20,22,42
08/23/2019,Staten Island,Lyons,Early Bird,0,0,0,6,11,17
08/23/2019,Queens,Astoria,Early Bird,0,1,1,36,36,72
08/23/2019,Bronx,Crotona,Early Bird,0,0,0,3,2,5
08/23/2019,Bronx,Van Cortlandt,Early Bird,0,0,0,0,0,0
08/23/2019,Brooklyn,Kosciuszko,Early Bird,0,0,0,8,6,14
08/23/2019,Brooklyn,Sunset,Early Bird,0,0,0,0,0,0
08/23/2019,Brooklyn,Red Hook,Early Bird,1,2,3,13,22,35
08/23/2019,Brooklyn,McCarren,Early Bird,2,1,3,56,38,94
08/23/2019,Manhattan,Thomas Jefferson,Early Bird,0,0,0,6,5,11
08/23/2019,Manhattan,Tony Dapolito,Early Bird,0,0,0,13,9,22
08/23/2019,Manhattan,Jackie Robinson,Early Bird,0,0,0,12,21,33
08/23/2019,Manhattan,Asser Levy,Early Bird,0,1,1,14,20,34
08/23/2019,Manhattan,John Jay,Early Bird,3,3,6,22,27,49
08/23/2019,Manhattan,Lasker,Early Bird,0,1,1,25,33,58
08/23/2019,Manhattan,Hamilton Fish,Early Bird,1,0,1,29,37,66
08/22/2019,Staten Island,Lyons,Early Bird,0,0,0,8,8,16
08/22/2019,Queens,Astoria,Early Bird,1,3,4,49,50,99
08/22/2019,Bronx,Crotona,Early Bird,0,0,0,4,1,5
08/22/2019,Bronx,Van Cortlandt,Early Bird,0,0,0,17,9,26
08/22/2019,Brooklyn,Kosciuszko,Early Bird,2,3,5,14,19,33
08/22/2019,Brooklyn,Red Hook,Early Bird,0,0,0,15,16,31
08/22/2019,Brooklyn,Sunset,Early Bird,1,2,3,22,26,48
08/22/2019,Brooklyn,McCarren,Early Bird,7,6,13,74,59,133
08/22/2019,Manhattan,Thomas Jefferson,Early Bird,0,0,0,12,11,23
08/22/2019,Manhattan,Tony Dapolito,Early Bird,0,1,1,10,15,25
08/22/2019,Manhattan,Jackie Robinson,Early Bird,0,2,2,8,25,33
08/22/2019,Manhattan,Asser Levy,Early Bird,2,1,3,17,24,41
08/22/2019,Manhattan,John Jay,Early Bird,1,3,4,34,39,73
08/22/2019,Manhattan,Lasker,Early Bird,6,6,12,35,42,77
08/22/2019,Manhattan,Hamilton Fish,Early Bird,1,1,2,41,38,79
08/21/2019,Staten Island,Lyons,Early Bird,0,0,0,9,8,17
08/21/2019,Queens,Astoria,Early Bird,1,0,1,4,35,39
08/21/2019,Bronx,Crotona,Early Bird,0,0,0,3,4,7
08/21/2019,Bronx,Van Cortlandt,Early Bird,3,0,3,23,10,33
08/21/2019,Brooklyn,Kosciuszko,Early Bird,1,3,4,10,4,14
08/21/2019,Brooklyn,Red Hook,Early Bird,0,1,1,18,19,37
08/21/2019,Brooklyn,Sunset,Early Bird,0,0,0,29,30,59
08/21/2019,Brooklyn,McCarren,Early Bird,1,4,5,65,72,137
08/21/2019,Manhattan,Thomas Jefferson,Early Bird,0,0,0,9,8,17
08/21/2019,Manhattan,Tony Dapolito,Early Bird,1,1,2,9,17,26
08/21/2019,Manhattan,Jackie Robinson,Early Bird,0,0,0,14,25,39
08/21/2019,Manhattan,Asser Levy,Early Bird,0,0,0,14,25,39
08/21/2019,Manhattan,John Jay,Early Bird,3,0,3,33,37,70
08/21/2019,Manhattan,Lasker,Early Bird,3,2,5,31,40,71
08/21/2019,Manhattan,Hamilton Fish,Early Bird,0,2,2,37,50,87
08/20/2019,Staten Island,Lyons,Early Bird,1,0,1,9,8,17
08/20/2019,Queens,Astoria,Early Bird,0,1,1,49,63,112
08/20/2019,Bronx,Crotona,Early Bird,0,0,0,1,2,3
08/20/2019,Bronx,Van Cortlandt,Early Bird,1,0,1,21,17,38
08/20/2019,Brooklyn,Kosciuszko,Early Bird,0,0,0,0,0,0
08/20/2019,Brooklyn,Red Hook,Early Bird,2,1,3,26,23,49
08/20/2019,Brooklyn,Sunset,Early Bird,0,2,2,29,39,68
08/20/2019,Brooklyn,McCarren,Early Bird,4,5,9,76,72,148
08/20/2019,Manhattan,Thomas Jefferson,Early Bird,0,0,0,8,11,19
08/20/2019,Manhattan,Tony Dapolito,Early Bird,0,0,0,12,15,27
08/20/2019,Manhattan,Jackie Robinson,Early Bird,0,1,1,10,21,31
08/20/2019,Manhattan,Asser Levy,Early Bird,0,1,1,11,22,33
08/20/2019,Manhattan,John Jay,Early Bird,2,3,5,35,35,70
08/20/2019,Manhattan,Lasker,Early Bird,2,1,3,29,22,51
08/20/2019,Manhattan,Hamilton Fish,Early Bird,1,3,4,45,36,81
08/19/2019,Staten Island,Lyons,Early Bird,0,0,0,9,9,18
08/19/2019,Queens,Astoria,Early Bird,0,9,9,38,48,86
08/19/2019,Bronx,Crotona,Early Bird,0,0,0,2,2,4
08/19/2019,Bronx,Van Cortlandt,Early Bird,1,1,2,25,19,44
08/19/2019,Brooklyn,Kosciuszko,Early Bird,1,1,2,7,12,19
08/19/2019,Brooklyn,Red Hook,Early Bird,0,4,4,20,31,51
08/19/2019,Brooklyn,Sunset,Early Bird,3,1,4,34,34,68
08/19/2019,Brooklyn,McCarren,Early Bird,2,5,7,66,73,139
08/19/2019,Manhattan,Thomas Jefferson,Early Bird,1,0,1,7,11,18
08/19/2019,Manhattan,Tony Dapolito,Early Bird,1,1,2,9,19,28
08/19/2019,Manhattan,Jackie Robinson,Early Bird,0,1,1,11,30,41
08/19/2019,Manhattan,Asser Levy,Early Bird,2,0,2,22,30,52
08/19/2019,Manhattan,John Jay,Early Bird,4,6,10,29,40,69
08/19/2019,Manhattan,Lasker,Early Bird,3,3,6,31,45,76
08/19/2019,Manhattan,Hamilton Fish,Early Bird,0,0,0,44,49,93
08/16/2019,Staten Island,Lyons,Early Bird,2,1,3,12,7,19
08/16/2019,Queens,Astoria,Early Bird,2,0,2,41,44,85
08/16/2019,Bronx,Crotona,Early Bird,0,0,0,2,1,3
08/16/2019,Bronx,Van Cortlandt,Early Bird,1,1,2,24,21,45
08/16/2019,Brooklyn,Kosciuszko,Early Bird,2,2,4,12,12,24
08/16/2019,Brooklyn,Red Hook,Early Bird,1,0,1,0,0,0
08/16/2019,Manhattan,Sunset,Early Bird,1,0,1,28,38,66
08/16/2019,Brooklyn,McCarren,Early Bird,2,0,2,54,52,106
08/16/2019,Manhattan,Thomas Jefferson,Early Bird,0,1,1,9,12,21
08/16/2019,Manhattan,Tony Dapolito,Early Bird,0,0,0,9,20,29
08/16/2019,Manhattan,Jackie Robinson,Early Bird,0,2,2,17,25,42
08/16/2019,Manhattan,Asser Levy,Early Bird,0,0,0,16,25,41
08/16/2019,Manhattan,John Jay,Early Bird,1,2,3,25,38,63
08/16/2019,Manhattan,Lasker,Early Bird,1,1,2,28,45,73
08/16/2019,Manhattan,Hamilton Fish,Early Bird,1,4,5,38,41,79
08/15/2019,Staten Island,Lyons,Early Bird,0,0,0,6,9,15
08/15/2019,Queens,Astoria,Early Bird,0,1,1,52,42,94
08/15/2019,Bronx,Crotona,Early Bird,0,1,1,2,3,5
08/15/2019,Bronx,Van Cortlandt,Early Bird,0,1,1,15,14,29
08/15/2019,Brooklyn,Kosciuszko,Early Bird,0,2,2,11,16,27
08/15/2019,Brooklyn,Red Hook,Early Bird,0,2,2,13,22,35
08/15/2019,Brooklyn,Sunset,Early Bird,1,0,1,25,32,57
08/15/2019,Brooklyn,McCarren,Early Bird,3,1,4,58,60,118
08/15/2019,Manhattan,Thomas Jefferson,Early Bird,0,0,0,8,6,14
08/15/2019,Manhattan,Tony Dapolito,Early Bird,0,1,1,9,17,26
08/15/2019,Manhattan,Jackie Robinson,Early Bird,0,0,0,11,27,38
08/15/2019,Manhattan,Asser Levy,Early Bird,0,0,0,15,18,33
08/15/2019,Manhattan,John Jay,Early Bird,1,2,3,30,36,66
08/15/2019,Manhattan,Lasker,Early Bird,2,1,3,25,45,70
08/15/2019,Manhattan,Hamilton Fish,Early Bird,2,1,3,40,41,81
08/14/2019,Staten Island,Lyons,Early Bird,1,1,2,8,15,23
08/14/2019,Queens,Astoria,Early Bird,1,1,2,45,38,83
08/14/2019,Bronx,Crotona,Early Bird,0,0,0,3,3,6
08/14/2019,Bronx,Van Cortlandt,Early Bird,5,0,5,19,13,32
08/14/2019,Brooklyn,Kosciuszko,Early Bird,2,3,5,13,16,29
08/14/2019,Brooklyn,Red Hook,Early Bird,0,0,0,23,15,38
08/14/2019,Brooklyn,Sunset,Early Bird,1,0,1,29,35,64
08/14/2019,Brooklyn,McCarren,Early Bird,4,2,6,67,58,125
08/14/2019,Manhattan,Thomas Jefferson,Early Bird,0,0,0,12,12,24
08/14/2019,Manhattan,Tony Dapolito,Early Bird,0,0,0,11,15,26
08/14/2019,Manhattan,Jackie Robinson,Early Bird,1,1,2,14,28,42
08/14/2019,Manhattan,Asser Levy,Early Bird,0,0,0,18,22,40
08/14/2019,Manhattan,John Jay,Early Bird,2,0,2,25,26,51
08/14/2019,Manhattan,Lasker,Early Bird,3,1,4,28,36,64
08/14/2019,Manhattan,Hamilton Fish,Early Bird,2,2,4,46,47,93
08/13/2019,Staten Island,Lyons,Early Bird,0,0,0,4,7,11
08/13/2019,Queens,Astoria,Early Bird,1,0,1,42,38,80
08/13/2019,Bronx,Crotona,Early Bird,0,0,0,1,2,3
08/13/2019,Bronx,Van Cortlandt,Early Bird,0,0,0,14,10,24
08/13/2019,Brooklyn,Kosciuszko,Early Bird,1,0,1,7,10,17
08/13/2019,Brooklyn,Red Hook,Early Bird,4,2,6,19,24,43
08/13/2019,Brooklyn,Sunset,Early Bird,2,3,5,27,36,63
08/13/2019,Brooklyn,McCarren,Early Bird,2,2,4,48,53,101
08/13/2019,Manhattan,Thomas Jefferson,Early Bird,0,0,0,10,18,28
08/13/2019,Manhattan,Tony Dapolito,Early Bird,0,0,0,10,21,31
08/13/2019,Manhattan,Jackie Robinson,Early Bird,1,0,1,9,16,25
08/13/2019,Manhattan,Asser Levy,Early Bird,0,0,0,17,16,33
08/13/2019,Manhattan,John Jay,Early Bird,0,2,2,26,25,51
08/13/2019,Manhattan,Lasker,Early Bird,3,0,3,36,31,67
08/13/2019,Manhattan,Hamilton Fish,Early Bird,2,2,4,34,31,65
08/12/2019,Staten Island,Lyons,Early Bird,0,0,0,7,9,16
08/12/2019,Queens,Astoria,Early Bird,2,2,4,52,43,95
08/12/2019,Bronx,Crotona,Early Bird,1,1,2,2,3,5
08/12/2019,Bronx,Van Cortlandt,Early Bird,0,0,0,19,15,34
08/12/2019,Brooklyn,Kosciuszko,Early Bird,2,1,3,13,14,27
08/12/2019,Brooklyn,Red Hook,Early Bird,2,5,7,27,22,49
08/12/2019,Brooklyn,Sunset,Early Bird,4,2,6,37,38,75
08/12/2019,Brooklyn,McCarren,Early Bird,6,4,10,60,60,120
08/12/2019,Manhattan,Thomas Jefferson,Early Bird,0,0,0,12,14,26
08/12/2019,Manhattan,Tony Dapolito,Early Bird,0,1,1,10,15,25
08/12/2019,Manhattan,Jackie Robinson,Early Bird,2,3,5,26,16,42
08/12/2019,Manhattan,Asser Levy,Early Bird,2,0,2,15,23,38
08/12/2019,Manhattan,John Jay,Early Bird,8,7,15,32,37,69
08/12/2019,Manhattan,Lasker,Early Bird,4,2,6,29,43,72
08/12/2019,Manhattan,Hamilton Fish,Early Bird,1,5,6,40,48,88
08/09/2019,Staten Island,Lyons,Early Bird,0,0,0,7,7,14
08/09/2019,Queens,Astoria,Early Bird,3,2,5,50,45,95
08/09/2019,Bronx,Crotona,Early Bird,0,0,0,3,3,6
08/09/2019,Bronx,Van Cortlandt,Early Bird,2,3,5,24,21,45
08/09/2019,Brooklyn,Kosciuszko,Early Bird,0,1,1,17,17,34
08/09/2019,Brooklyn,Red Hook,Early Bird,4,1,5,23,26,49
08/09/2019,Brooklyn,Sunset,Early Bird,0,2,2,33,40,73
08/09/2019,Brooklyn,McCarren,Early Bird,10,2,12,82,76,158
08/09/2019,Manhattan,Thomas Jefferson,Early Bird,0,0,0,10,6,16
08/09/2019,Manhattan,Tony Dapolito,Early Bird,0,0,0,11,16,27
08/09/2019,Manhattan,Jackie Robinson,Early Bird,3,0,3,13,30,43
08/09/2019,Manhattan,Asser Levy,Early Bird,1,0,1,17,25,42
08/09/2019,Manhattan,John Jay,Early Bird,0,1,1,25,46,71
08/09/2019,Manhattan,Lasker,Early Bird,4,5,9,46,54,100
08/09/2019,Manhattan,Hamilton Fish,Early Bird,0,0,0,48,58,106
08/07/2019,Brooklyn,Kosciuszko,Early Bird,2,4,6,12,10,22
08/06/2019,Brooklyn,Kosciuszko,Early Bird,3,1,4,10,28,38
08/05/2019,Brooklyn,Kosciuszko,Early Bird,2,2,4,18,15,33
08/02/2019,Brooklyn,Kosciuszko,Early Bird,4,3,7,22,17,39
08/01/2019,Brooklyn,Kosciuszko,Early Bird,2,4,6,13,19,32
07/31/2019,Brooklyn,Kosciuszko,Early Bird,3,5,8,13,19,32
07/30/2019,Brooklyn,Kosciuszko,Early Bird,3,11,14,15,25,40
07/29/2019,Brooklyn,Kosciuszko,Early Bird,3,4,7,14,20,34
07/26/2019,Brooklyn,Kosciuszko,Early Bird,4,5,9,18,17,35
07/25/2019,Brooklyn,Kosciuszko,Early Bird,7,1,8,16,13,29
07/24/2019,Brooklyn,Kosciuszko,Early Bird,4,7,11,15,20,35
07/23/2019,Brooklyn,Kosciuszko,Early Bird,2,3,5,3,6,9
07/22/2019,Brooklyn,Kosciuszko,Early Bird,4,11,15,16,19,35
07/19/2019,Brooklyn,Kosciuszko,Early Bird,2,1,3,10,8,18
07/18/2019,Brooklyn,Kosciuszko,Early Bird,1,3,4,1,3,4
07/17/2019,Brooklyn,Kosciuszko,Early Bird,6,6,12,15,15,30
07/16/2019,Brooklyn,Kosciuszko,Early Bird,4,16,20,21,26,47
07/15/2019,Brooklyn,Kosciuszko,Early Bird,6,9,15,13,17,30
07/12/2019,Brooklyn,Kosciuszko,Early Bird,8,9,17,19,16,35
07/11/2019,Brooklyn,Kosciuszko,Early Bird,7,6,13,13,16,29
07/10/2019,Brooklyn,Kosciuszko,Early Bird,10,16,26,14,23,37
07/09/2019,Brooklyn,Kosciuszko,Early Bird,13,20,33,16,25,41
07/08/2019,Brooklyn,Kosciuszko,Early Bird,9,8,17,10,10,20
07/05/2019,Brooklyn,Kosciuszko,Early Bird,10,12,22,10,12,22
08/08/2019,Brooklyn,Kosciuszko,Early Bird,3,5,8,12,17,29
08/08/2019,Staten Island,Lyons,Early Bird,0,0,0,7,6,13
08/08/2019,Queens,Astoria,Early Bird,0,4,4,46,45,91
08/08/2019,Bronx,Crotona,Early Bird,0,0,0,2,1,3
08/08/2019,Bronx,Van Cortlandt,Early Bird,1,3,4,17,17,34
08/08/2019,Brooklyn,Red Hook,Early Bird,1,0,1,18,20,38
08/08/2019,Brooklyn,Sunset,Early Bird,1,1,2,26,32,58
08/08/2019,Brooklyn,McCarren,Early Bird,3,8,11,57,55,112
08/08/2019,Manhattan,Thomas Jefferson,Early Bird,0,1,1,10,13,23
08/08/2019,Manhattan,Tony Dapolito,Early Bird,0,1,1,7,19,26
08/08/2019,Manhattan,Jackie Robinson,Early Bird,0,1,1,11,25,36
08/08/2019,Manhattan,Asser Levy,Early Bird,0,1,1,11,18,29
08/08/2019,Manhattan,John Jay,Early Bird,1,0,1,23,32,55
08/08/2019,Manhattan,Lasker,Early Bird,1,1,2,35,40,75
08/08/2019,Manhattan,Hamilton Fish,Early Bird,4,3,7,38,49,87
08/07/2019,Staten Island,Lyons,Early Bird,0,0,0,1,6,7
08/07/2019,Queens,Astoria,Early Bird,0,7,7,49,43,92
08/07/2019,Bronx,Crotona,Early Bird,0,0,0,1,3,4
08/07/2019,Bronx,Van Cortlandt,Early Bird,1,1,2,17,13,30
08/07/2019,Brooklyn,Red Hook,Early Bird,2,1,3,16,18,34
08/07/2019,Brooklyn,Sunset,Early Bird,2,2,4,15,21,36
08/07/2019,Brooklyn,McCarren,Early Bird,7,4,11,63,51,114
08/07/2019,Manhattan,Thomas Jefferson,Early Bird,0,0,0,11,11,22
08/07/2019,Manhattan,Tony Dapolito,Early Bird,1,0,1,13,23,36
08/07/2019,Manhattan,Jackie Robinson,Early Bird,2,0,2,15,21,36
08/07/2019,Manhattan,Asser Levy,Early Bird,0,2,2,13,26,39
08/07/2019,Manhattan,John Jay,Early Bird,0,2,2,31,40,71
08/07/2019,Manhattan,Lasker,Early Bird,7,8,15,32,50,82
08/07/2019,Manhattan,Hamilton Fish,Early Bird,1,0,1,27,34,61
08/06/2019,Staten Island,Lyons,Early Bird,0,0,0,8,7,15
08/06/2019,Queens,Astoria,Early Bird,1,4,5,49,36,85
08/06/2019,Bronx,Crotona,Early Bird,0,0,0,2,3,5
08/06/2019,Bronx,Van Cortlandt,Early Bird,0,1,1,14,10,24
08/06/2019,Brooklyn,Red Hook,Early Bird,0,0,0,0,0,0
08/06/2019,Brooklyn,Sunset,Early Bird,0,0,0,0,0,0
08/06/2019,Brooklyn,McCarren,Early Bird,9,4,13,71,79,150
08/06/2019,Manhattan,Thomas Jefferson,Early Bird,1,2,3,14,12,26
08/06/2019,Manhattan,Tony Dapolito,Early Bird,1,0,1,13,22,35
08/06/2019,Manhattan,Jackie Robinson,Early Bird,2,3,5,15,31,46
08/06/2019,Manhattan,Asser Levy,Early Bird,1,0,1,23,20,43
08/06/2019,Manhattan,John Jay,Early Bird,0,0,0,28,31,59
08/06/2019,Manhattan,Lasker,Early Bird,5,4,9,38,36,74
08/06/2019,Manhattan,Hamilton Fish,Early Bird,2,6,8,43,57,100
08/05/2019,Staten Island,Lyons,Early Bird,0,0,0,10,8,18
08/05/2019,Queens,Astoria,Early Bird,6,2,8,56,36,92
08/05/2019,Bronx,Crotona,Early Bird,0,0,0,0,2,2
08/05/2019,Bronx,Van Cortlandt,Early Bird,2,2,4,22,20,42
08/05/2019,Brooklyn,Red Hook,Early Bird,2,1,3,18,27,45
08/05/2019,Brooklyn,Sunset,Early Bird,3,2,5,33,37,70
08/05/2019,Brooklyn,McCarren,Early Bird,4,6,10,62,76,138
08/05/2019,Manhattan,Thomas Jefferson,Early Bird,0,2,2,9,12,21
08/05/2019,Manhattan,Tony Dapolito,Early Bird,2,2,4,8,26,34
08/05/2019,Manhattan,Jackie Robinson,Early Bird,1,3,4,12,28,40
08/05/2019,Manhattan,Asser Levy,Early Bird,1,1,2,19,23,42
08/05/2019,Manhattan,John Jay,Early Bird,1,3,4,30,39,69
08/05/2019,Manhattan,Lasker,Early Bird,9,11,20,37,50,87
08/05/2019,Manhattan,Hamilton Fish,Early Bird,0,0,0,0,0,0
08/02/2019,Staten Island,Lyons,Early Bird,2,0,2,16,7,23
08/02/2019,Queens,Astoria,Early Bird,2,3,5,67,60,127
08/02/2019,Bronx,Crotona,Early Bird,0,0,0,3,4,7
08/02/2019,Bronx,Van Cortlandt,Early Bird,1,1,2,22,22,44
08/02/2019,Brooklyn,Red Hook,Early Bird,2,4,6,28,40,68
08/02/2019,Brooklyn,Sunset,Early Bird,1,3,4,38,46,84
08/02/2019,Brooklyn,McCarren,Early Bird,0,5,5,66,79,145
08/02/2019,Manhattan,Thomas Jefferson,Early Bird,2,0,2,11,11,22
08/02/2019,Manhattan,Tony Dapolito,Early Bird,0,3,3,13,23,36
08/02/2019,Manhattan,Jackie Robinson,Early Bird,0,2,2,17,32,49
08/02/2019,Manhattan,Asser Levy,Early Bird,3,0,3,23,23,46
08/02/2019,Manhattan,John Jay,Early Bird,2,2,4,35,39,74
08/02/2019,Manhattan,Lasker,Early Bird,4,3,7,38,55,93
08/02/2019,Manhattan,Hamilton Fish,Early Bird,0,0,0,58,60,118
08/01/2019,Staten Island,Lyons,Early Bird,2,1,3,14,10,24
08/01/2019,Queens,Astoria,Early Bird,2,1,3,63,45,108
08/01/2019,Bronx,Crotona,Early Bird,0,0,0,3,3,6
08/01/2019,Bronx,Van Cortlandt,Early Bird,1,1,2,19,20,39
08/01/2019,Brooklyn,Red Hook,Early Bird,0,0,0,33,30,63
08/01/2019,Brooklyn,Sunset,Early Bird,1,2,3,29,29,58
08/01/2019,Brooklyn,McCarren,Early Bird,5,4,9,66,97,163
08/01/2019,Manhattan,Thomas Jefferson,Early Bird,0,0,0,9,22,31
08/01/2019,Manhattan,Tony Dapolito,Early Bird,0,0,0,12,12,24
08/01/2019,Manhattan,Jackie Robinson,Early Bird,2,3,5,17,39,56
08/01/2019,Manhattan,Asser Levy,Early Bird,0,3,3,17,39,56
08/01/2019,Manhattan,John Jay,Early Bird,2,6,8,37,38,75
08/01/2019,Manhattan,Lasker,Early Bird,0,2,2,31,42,73
08/01/2019,Manhattan,Hamilton Fish,Early Bird,4,7,11,55,57,112
07/31/2019,Staten Island,Lyons,Early Bird,1,0,1,13,15,28
07/31/2019,Queens,Astoria,Early Bird,5,5,10,60,55,115
07/31/2019,Bronx,Crotona,Early Bird,0,0,0,0,4,4
07/31/2019,Bronx,Van Cortlandt,Early Bird,0,0,0,18,21,39
07/31/2019,Brooklyn,Sunset,Early Bird,4,2,6,40,39,79
07/31/2019,Brooklyn,Red Hook,Early Bird,2,6,8,25,39,64
07/31/2019,Brooklyn,McCarren,Early Bird,11,11,22,65,90,155
07/31/2019,Manhattan,Tony Dapolito,Early Bird,4,5,9,19,25,44
07/31/2019,Manhattan,Thomas Jefferson,Early Bird,1,0,1,18,9,27
07/31/2019,Manhattan,Jackie Robinson,Early Bird,1,2,3,13,32,45
07/31/2019,Manhattan,Asser Levy,Early Bird,2,0,2,21,29,50
07/31/2019,Manhattan,Lasker,Early Bird,5,3,8,40,50,90
07/31/2019,Manhattan,John Jay,Early Bird,4,4,8,35,37,72
07/31/2019,Manhattan,Hamilton Fish,Early Bird,7,4,11,74,64,138
07/30/2019,Staten Island,Lyons,Early Bird,2,2,4,13,11,24
07/30/2019,Queens,Astoria,Early Bird,4,3,7,64,57,121
07/30/2019,Bronx,Crotona,Early Bird,0,1,1,2,3,5
07/30/2019,Bronx,Van Cortlandt,Early Bird,2,6,8,19,20,39
07/30/2019,Brooklyn,Sunset,Early Bird,2,1,3,36,37,73
07/30/2019,Brooklyn,Red Hook,Early Bird,7,4,11,30,45,75
07/30/2019,Brooklyn,McCarren,Early Bird,5,16,21,85,91,176
07/30/2019,Manhattan,Tony Dapolito,Early Bird,2,1,3,15,19,34
07/30/2019,Manhattan,Thomas Jefferson,Early Bird,3,3,6,18,16,34
07/30/2019,Manhattan,Jackie Robinson,Early Bird,3,4,7,14,33,47
07/30/2019,Manhattan,Asser Levy,Early Bird,2,0,2,22,28,50
07/30/2019,Manhattan,Lasker,Early Bird,8,4,12,45,46,91
07/30/2019,Manhattan,John Jay,Early Bird,1,4,5,33,48,81
07/30/2019,Manhattan,Hamilton Fish,Early Bird,2,5,7,55,69,124
07/29/2019,Staten Island,Lyons,Early Bird,4,0,4,15,9,24
07/29/2019,Queens,Astoria,Early Bird,3,8,11,58,62,120
07/29/2019,Bronx,Crotona,Early Bird,1,1,2,2,3,5
07/29/2019,Bronx,Van Cortlandt,Early Bird,2,1,3,21,18,39
07/29/2019,Brooklyn,Sunset,Early Bird,1,7,8,38,48,86
07/29/2019,Brooklyn,Red Hook,Early Bird,4,5,9,27,33,60
07/29/2019,Brooklyn,McCarren,Early Bird,9,14,23,77,93,170
07/29/2019,Manhattan,Tony Dapolito,Early Bird,1,2,3,14,18,32
07/29/2019,Manhattan,Thomas Jefferson,Early Bird,1,3,4,10,18,28
07/29/2019,Manhattan,Jackie Robinson,Early Bird,4,6,10,19,32,51
07/29/2019,Manhattan,Asser Levy,Early Bird,2,0,2,17,25,42
07/29/2019,Manhattan,Lasker,Early Bird,7,7,14,36,54,90
07/29/2019,Manhattan,John Jay,Early Bird,2,3,5,25,37,62
07/29/2019,Manhattan,Hamilton Fish,Early Bird,4,3,7,61,58,119
07/26/2019,Staten Island,Lyons,Early Bird,0,1,1,11,10,21
07/26/2019,Queens,Astoria,Early Bird,3,2,5,58,54,112
07/26/2019,Bronx,Crotona,Early Bird,0,0,0,1,3,4
07/26/2019,Bronx,Van Cortlandt,Early Bird,0,2,2,20,21,41
07/26/2019,Brooklyn,Sunset,Early Bird,0,0,0,0,0,0
07/26/2019,Brooklyn,Red Hook,Early Bird,1,7,8,23,44,67
07/26/2019,Brooklyn,McCarren,Early Bird,5,11,16,68,89,157
07/26/2019,Manhattan,Tony Dapolito,Early Bird,2,4,6,14,20,34
07/26/2019,Manhattan,Thomas Jefferson,Early Bird,0,1,1,9,14,23
07/26/2019,Manhattan,Jackie Robinson,Early Bird,0,1,1,9,14,23
07/26/2019,Manhattan,Asser Levy,Early Bird,1,2,3,16,35,51
07/26/2019,Manhattan,Lasker,Early Bird,7,7,14,40,52,92
07/26/2019,Manhattan,John Jay,Early Bird,1,4,5,43,63,106
07/26/2019,Manhattan,Hamilton Fish,Early Bird,4,1,5,60,60,120
07/25/2019,Staten Island,Lyons,Early Bird,0,0,0,9,10,19
07/25/2019,Queens,Astoria,Early Bird,4,6,10,55,44,99
07/25/2019,Bronx,Crotona,Early Bird,0,0,0,1,4,5
07/25/2019,Bronx,Van Cortlandt,Early Bird,1,1,2,16,17,33
07/25/2019,Brooklyn,Sunset,Early Bird,4,3,7,40,34,74
07/25/2019,Brooklyn,Red Hook,Early Bird,4,3,7,28,30,58
07/25/2019,Brooklyn,McCarren,Early Bird,2,3,5,76,62,138
07/25/2019,Manhattan,Tony Dapolito,Early Bird,1,1,2,15,18,33
07/25/2019,Manhattan,Thomas Jefferson,Early Bird,1,4,5,13,17,30
07/25/2019,Manhattan,Jackie Robinson,Early Bird,0,3,3,10,25,35
07/25/2019,Manhattan,Asser Levy,Early Bird,3,0,3,17,20,37
07/25/2019,Manhattan,Lasker,Early Bird,3,5,8,36,32,68
07/25/2019,Manhattan,John Jay,Early Bird,4,3,7,35,42,77
07/25/2019,Manhattan,Hamilton Fish,Early Bird,4,8,12,40,60,100
07/24/2019,Staten Island,Lyons,Early Bird,3,3,6,13,12,25
07/24/2019,Queens,Astoria,Early Bird,9,4,13,61,48,109
07/24/2019,Bronx,Crotona,Early Bird,0,2,2,1,5,6
07/24/2019,Bronx,Van Cortlandt,Early Bird,0,2,2,17,19,36
07/24/2019,Brooklyn,Sunset,Early Bird,2,2,4,36,44,80
07/24/2019,Brooklyn,Red Hook,Early Bird,2,5,7,22,28,50
07/24/2019,Brooklyn,McCarren,Early Bird,9,9,18,77,66,143
07/24/2019,Manhattan,Tony Dapolito,Early Bird,1,0,1,15,23,38
07/24/2019,Manhattan,Thomas Jefferson,Early Bird,0,2,2,11,12,23
07/24/2019,Manhattan,Jackie Robinson,Early Bird,0,2,2,8,34,42
07/24/2019,Manhattan,Asser Levy,Early Bird,1,1,2,18,29,47
07/24/2019,Manhattan,Lasker,Early Bird,2,5,7,31,32,63
07/24/2019,Manhattan,John Jay,Early Bird,5,4,9,40,50,90
07/24/2019,Manhattan,Hamilton Fish,Early Bird,2,3,5,58,67,125
07/23/2019,Staten Island,Lyons,Early Bird,0,0,0,4,3,7
07/23/2019,Queens,Astoria,Early Bird,0,0,0,19,12,31
07/23/2019,Bronx,Crotona,Early Bird,0,0,0,0,1,1
07/23/2019,Bronx,Van Cortlandt,Early Bird,0,0,0,4,4,8
07/23/2019,Brooklyn,Sunset,Early Bird,0,0,0,12,12,24
07/23/2019,Brooklyn,Red Hook,Early Bird,0,0,0,11,3,14
07/23/2019,Brooklyn,McCarren,Early Bird,0,1,1,21,18,39
07/23/2019,Manhattan,Tony Dapolito,Early Bird,0,0,0,6,13,19
07/23/2019,Manhattan,Thomas Jefferson,Early Bird,0,0,0,8,4,12
07/23/2019,Manhattan,Jackie Robinson,Early Bird,0,0,0,8,4,12
07/23/2019,Manhattan,Asser Levy,Early Bird,0,0,0,11,5,16
07/23/2019,Manhattan,Lasker,Early Bird,0,0,0,0,0,0
07/23/2019,Manhattan,John Jay,Early Bird,0,0,0,12,14,26
07/23/2019,Manhattan,Hamilton Fish,Early Bird,1,0,1,17,13,30
07/22/2019,Staten Island,Lyons,Early Bird,3,0,3,12,15,27
07/22/2019,Queens,Astoria,Early Bird,6,9,15,60,47,107
07/22/2019,Bronx,Crotona,Early Bird,0,0,0,2,2,4
07/22/2019,Bronx,Van Cortlandt,Early Bird,3,3,6,17,20,37
07/22/2019,Brooklyn,Sunset,Early Bird,3,3,6,37,46,83
07/22/2019,Brooklyn,Red Hook,Early Bird,5,2,7,25,20,45
07/22/2019,Brooklyn,McCarren,Early Bird,9,17,26,70,78,148
07/22/2019,Manhattan,Tony Dapolito,Early Bird,1,4,5,11,25,36
07/22/2019,Manhattan,Thomas Jefferson,Early Bird,2,3,5,11,16,27
07/22/2019,Manhattan,Jackie Robinson,Early Bird,1,0,1,14,27,41
07/22/2019,Manhattan,Asser Levy,Early Bird,3,3,6,23,32,55
07/22/2019,Manhattan,Lasker,Early Bird,6,14,20,44,56,100
07/22/2019,Manhattan,John Jay,Early Bird,5,6,11,37,46,83
07/22/2019,Manhattan,Hamilton Fish,Early Bird,3,3,6,65,67,132
07/19/2019,Staten Island,Lyons,Early Bird,2,2,4,13,13,26
07/19/2019,Queens,Astoria,Early Bird,2,5,7,33,38,71
07/19/2019,Bronx,Crotona,Early Bird,0,0,0,2,1,3
07/19/2019,Bronx,Van Cortlandt,Early Bird,1,3,4,20,20,40
07/19/2019,Brooklyn,Red Hook,Early Bird,4,12,16,25,40,65
07/19/2019,Brooklyn,Sunset,Early Bird,7,3,10,27,43,70
07/19/2019,Brooklyn,McCarren,Early Bird,9,7,16,79,77,156
07/19/2019,Manhattan,Thomas Jefferson,Early Bird,1,0,1,9,8,17
07/19/2019,Manhattan,Jackie Robinson,Early Bird,1,1,2,9,24,33
07/19/2019,Manhattan,Tony Dapolito,Early Bird,3,1,4,17,19,36
07/19/2019,Manhattan,Asser Levy,Early Bird,0,3,3,20,35,55
07/19/2019,Manhattan,John Jay,Early Bird,3,5,8,40,39,79
07/19/2019,Manhattan,Lasker,Early Bird,1,7,8,42,50,92
07/19/2019,Manhattan,Hamilton Fish,Early Bird,6,4,10,66,60,126
07/18/2019,Staten Island,Lyons,Early Bird,0,0,0,10,6,16
07/18/2019,Queens,Astoria,Early Bird,0,2,2,0,0,0
07/18/2019,Bronx,Crotona,Early Bird,0,0,0,3,1,4
07/18/2019,Bronx,Van Cortlandt,Early Bird,0,2,2,11,11,22
07/18/2019,Brooklyn,Red Hook,Early Bird,0,0,0,17,16,33
07/18/2019,Brooklyn,Sunset,Early Bird,2,3,5,24,30,54
07/18/2019,Brooklyn,McCarren,Early Bird,10,10,20,63,50,113
07/18/2019,Manhattan,Thomas Jefferson,Early Bird,0,1,1,9,9,18
07/18/2019,Manhattan,Tony Dapolito,Early Bird,2,2,4,11,17,28
07/18/2019,Manhattan,Jackie Robinson,Early Bird,0,3,3,6,24,30
07/18/2019,Manhattan,Asser Levy,Early Bird,1,0,1,16,16,32
07/18/2019,Manhattan,Lasker,Early Bird,7,9,16,23,34,57
07/18/2019,Manhattan,John Jay,Early Bird,2,4,6,25,37,62
07/18/2019,Manhattan,Hamilton Fish,Early Bird,4,4,8,43,41,84
07/17/2019,Staten Island,Lyons,Early Bird,4,2,6,15,13,28
07/17/2019,Queens,Astoria,Early Bird,0,1,1,0,0,0
07/17/2019,Bronx,Crotona,Early Bird,0,0,0,1,2,3
07/17/2019,Bronx,Van Cortlandt,Early Bird,2,6,8,17,22,39
07/17/2019,Brooklyn,Red Hook,Early Bird,5,4,9,22,26,48
07/17/2019,Brooklyn,Sunset,Early Bird,2,5,7,40,46,86
07/17/2019,Brooklyn,McCarren,Early Bird,26,16,42,98,83,181
07/17/2019,Manhattan,Thomas Jefferson,Early Bird,3,0,3,15,10,25
07/17/2019,Manhattan,Tony Dapolito,Early Bird,2,4,6,15,19,34
07/17/2019,Manhattan,Jackie Robinson,Early Bird,2,7,9,14,35,49
07/17/2019,Manhattan,Asser Levy,Early Bird,2,5,7,20,33,53
07/17/2019,Manhattan,John Jay,Early Bird,3,9,12,37,52,89
07/17/2019,Manhattan,Lasker,Early Bird,11,8,19,52,61,113
07/17/2019,Manhattan,Hamilton Fish,Early Bird,10,9,19,70,71,141
07/16/2019,Staten Island,Lyons,Early Bird,1,2,3,10,15,25
07/16/2019,Queens,Astoria,Early Bird,10,13,23,65,68,133
07/16/2019,Bronx,Crotona,Early Bird,0,0,0,2,1,3
07/16/2019,Bronx,Van Cortlandt,Early Bird,1,1,2,18,17,35
07/16/2019,Brooklyn,Red Hook,Early Bird,2,7,9,23,41,64
07/16/2019,Brooklyn,Sunset,Early Bird,8,9,17,43,44,87
07/16/2019,Brooklyn,McCarren,Early Bird,29,30,59,116,112,228
07/16/2019,Manhattan,Thomas Jefferson,Early Bird,1,5,6,12,21,33
07/16/2019,Manhattan,Tony Dapolito,Early Bird,4,3,7,19,18,37
07/16/2019,Manhattan,Jackie Robinson,Early Bird,2,9,11,13,34,47
07/16/2019,Manhattan,Asser Levy,Early Bird,2,6,8,26,28,54
07/16/2019,Manhattan,John Jay,Early Bird,7,6,13,42,43,85
07/16/2019,Manhattan,Hamilton Fish,Early Bird,4,8,12,37,48,85
07/16/2019,Manhattan,Lasker,Early Bird,33,37,70,56,55,111
07/15/2019,Staten Island,Lyons,Early Bird,2,3,5,13,14,27
07/15/2019,Queens,Astoria,Early Bird,10,15,25,60,64,124
07/15/2019,Bronx,Crotona,Early Bird,2,0,2,4,4,8
07/15/2019,Bronx,Van Cortlandt,Early Bird,3,6,9,21,28,49
07/15/2019,Brooklyn,Sunset,Early Bird,7,5,12,36,43,79
07/15/2019,Brooklyn,Red Hook,Early Bird,4,6,10,28,28,56
07/15/2019,Brooklyn,McCarren,Early Bird,26,26,52,93,94,187
07/15/2019,Manhattan,Tony Dapolito,Early Bird,3,3,6,15,16,31
07/15/2019,Manhattan,Thomas Jefferson,Early Bird,1,6,7,10,11,21
07/15/2019,Manhattan,Jackie Robinson,Early Bird,1,14,15,13,33,46
07/15/2019,Manhattan,Asser Levy,Early Bird,3,4,7,21,33,54
07/15/2019,Manhattan,Lasker,Early Bird,7,24,31,52,52,104
07/15/2019,Manhattan,John Jay,Early Bird,6,14,20,43,47,90
07/15/2019,Manhattan,Hamilton Fish,Early Bird,14,6,20,63,62,125
07/12/2019,Manhattan,Jackie Robinson,Early Bird,3,6,9,14,26,40
07/12/2019,Staten Island,Lyons,Early Bird,2,5,7,15,15,30
07/12/2019,Queens,Astoria,Early Bird,9,14,23,58,50,108
07/12/2019,Bronx,Crotona,Early Bird,0,0,0,2,2,4
07/12/2019,Bronx,Van Cortlandt,Early Bird,1,4,5,15,20,35
07/12/2019,Brooklyn,Sunset,Early Bird,1,6,7,31,41,72
07/12/2019,Brooklyn,Red Hook,Early Bird,4,5,9,26,25,51
07/12/2019,Brooklyn,McCarren,Early Bird,24,24,48,81,80,161
07/12/2019,Manhattan,Tony Dapolito,Early Bird,5,4,9,19,20,39
07/12/2019,Manhattan,Thomas Jefferson,Early Bird,1,2,3,9,10,19
07/12/2019,Manhattan,Asser Levy,Early Bird,3,6,9,14,26,40
07/12/2019,Manhattan,Lasker,Early Bird,10,10,20,52,47,99
07/12/2019,Manhattan,John Jay,Early Bird,1,10,11,38,46,84
07/12/2019,Manhattan,Hamilton Fish,Early Bird,13,15,28,72,72,144
07/11/2019,Staten Island,Lyons,Early Bird,1,4,5,11,11,22
07/11/2019,Queens,Astoria,Early Bird,8,15,23,51,58,109
07/11/2019,Bronx,Crotona,Early Bird,0,0,0,4,3,7
07/11/2019,Bronx,Van Cortlandt,Early Bird,1,3,4,17,14,31
07/11/2019,Brooklyn,Sunset,Early Bird,5,8,13,34,43,77
07/11/2019,Brooklyn,Red Hook,Early Bird,3,10,13,22,29,51
07/11/2019,Brooklyn,McCarren,Early Bird,20,29,49,69,48,117
07/11/2019,Manhattan,Tony Dapolito,Early Bird,3,7,10,17,26,43
07/11/2019,Manhattan,Thomas Jefferson,Early Bird,0,3,3,11,11,22
07/11/2019,Manhattan,Jackie Robinson,Early Bird,2,5,7,9,30,39
07/11/2019,Manhattan,Asser Levy,Early Bird,1,5,6,14,27,41
07/11/2019,Manhattan,Lasker,Early Bird,31,38,69,36,51,87
07/11/2019,Manhattan,John Jay,Early Bird,8,12,20,74,51,125
07/11/2019,Manhattan,Hamilton Fish,Early Bird,11,11,22,74,51,125
07/10/2019,Staten Island,Lyons,Early Bird,5,2,7,15,10,25
07/10/2019,Queens,Astoria,Early Bird,12,19,31,51,55,106
07/10/2019,Bronx,Crotona,Early Bird,1,1,2,22,4,26
07/10/2019,Bronx,Van Cortlandt,Early Bird,4,9,13,20,19,39
07/10/2019,Brooklyn,Sunset,Early Bird,9,7,16,38,44,82
07/10/2019,Brooklyn,Red Hook,Early Bird,4,11,15,28,33,61
07/10/2019,Brooklyn,McCarren,Early Bird,23,42,65,81,92,173
07/10/2019,Manhattan,Tony Dapolito,Early Bird,5,9,14,23,27,50
07/10/2019,Manhattan,Thomas Jefferson,Early Bird,13,12,25,25,25,50
07/10/2019,Manhattan,Jackie Robinson,Early Bird,3,11,14,14,33,47
07/10/2019,Manhattan,Asser Levy,Early Bird,9,11,20,20,36,56
07/10/2019,Manhattan,Lasker,Early Bird,12,11,23,44,47,91
07/10/2019,Manhattan,John Jay,Early Bird,12,15,27,35,45,80
07/10/2019,Manhattan,Hamilton Fish,Early Bird,24,23,47,63,70,133
07/09/2019,Staten Island,Lyons,Early Bird,3,2,5,10,9,19
07/09/2019,Queens,Astoria,Early Bird,20,27,47,49,62,111
07/09/2019,Bronx,Crotona,Early Bird,0,0,0,2,2,4
07/09/2019,Bronx,Van Cortlandt,Early Bird,4,7,11,20,14,34
07/09/2019,Brooklyn,Sunset,Early Bird,10,9,19,38,35,73
07/09/2019,Brooklyn,Red Hook,Early Bird,14,17,31,29,32,61
07/09/2019,Brooklyn,McCarren,Early Bird,32,47,79,73,81,154
07/09/2019,Manhattan,Tony Dapolito,Early Bird,3,7,10,16,21,37
07/09/2019,Manhattan,Thomas Jefferson,Early Bird,2,4,6,12,9,21
07/09/2019,Manhattan,Jackie Robinson,Early Bird,5,11,16,16,28,44
07/09/2019,Manhattan,Asser Levy,Early Bird,9,4,13,19,20,39
07/09/2019,Manhattan,Lasker,Early Bird,15,19,34,34,44,78
07/09/2019,Manhattan,John Jay,Early Bird,12,12,24,24,32,56
07/09/2019,Manhattan,Hamilton Fish,Early Bird,27,21,48,58,56,114
07/08/2019,Staten Island,Lyons,Early Bird,7,1,8,12,5,17
07/08/2019,Queens,Astoria,Early Bird,14,16,30,38,34,72
07/08/2019,Bronx,Crotona,Early Bird,0,0,0,3,1,4
07/08/2019,Bronx,Van Cortlandt,Early Bird,2,4,6,11,11,22
07/08/2019,Brooklyn,Sunset,Early Bird,13,15,28,29,29,58
07/08/2019,Brooklyn,Red Hook,Early Bird,15,14,29,21,20,41
07/08/2019,Brooklyn,McCarren,Early Bird,44,27,71,56,38,94
07/08/2019,Manhattan,Tony Dapolito,Early Bird,6,7,13,13,17,30
07/08/2019,Manhattan,Thomas Jefferson,Early Bird,5,7,12,11,10,21
07/08/2019,Manhattan,Jackie Robinson,Early Bird,4,8,12,14,21,35
07/08/2019,Manhattan,Asser Levy,Early Bird,7,5,12,15,18,33
07/08/2019,Manhattan,Lasker,Early Bird,51,58,109,39,25,64
07/08/2019,Manhattan,John Jay,Early Bird,5,23,28,33,31,64
07/08/2019,Manhattan,Hamilton Fish,Early Bird,26,30,56,39,51,90
07/05/2019,Staten Island,Lyons,Early Bird,10,12,22,10,12,22
07/05/2019,Queens,Astoria,Early Bird,50,45,95,50,45,95
07/05/2019,Bronx,Crotona,Early Bird,3,2,5,3,2,5
07/05/2019,Bronx,Van Cortlandt,Early Bird,24,20,44,24,20,44
07/05/2019,Brooklyn,Sunset,Early Bird,32,42,74,32,42,74
07/05/2019,Brooklyn,Red Hook,Early Bird,14,24,38,14,24,38
07/05/2019,Brooklyn,McCarren,Early Bird,46,37,83,46,37,83
07/05/2019,Manhattan,Tony Dapolito,Early Bird,11,16,27,11,16,27
07/05/2019,Manhattan,Thomas Jefferson,Early Bird,10,12,22,10,12,22
07/05/2019,Manhattan,Jackie Robinson,Early Bird,11,19,30,11,19,30
07/05/2019,Manhattan,Asser Levy,Early Bird,14,24,38,14,24,38
07/05/2019,Manhattan,Lasker,Early Bird,36,40,76,36,40,76
07/05/2019,Manhattan,John Jay,Early Bird,32,47,79,32,47,79
07/05/2019,Manhattan,Hamilton Fish,Early Bird,42,48,90,42,48,90
08/31/2018,Bronx,Crotona,Night Owl,0,0,0,3,3,6
08/30/2018,Bronx,Crotona,Night Owl,0,0,0,2,3,5
08/29/2018,Bronx,Crotona,Night Owl,0,3,3,2,5,7
08/28/2018,Bronx,Crotona,Night Owl,0,0,0,2,0,2
08/27/2018,Bronx,Crotona,Night Owl,0,0,0,5,3,8
08/31/2018,Bronx,Van Cortlandt,Night Owl,0,0,0,2,8,10
08/30/2018,Bronx,Van Cortlandt,Night Owl,0,0,0,7,7,14
08/29/2018,Bronx,Van Cortlandt,Night Owl,0,0,0,5,9,14
08/28/2018,Bronx,Van Cortlandt,Night Owl,1,0,1,5,3,8
08/27/2018,Bronx,Van Cortlandt,Night Owl,2,2,4,9,12,21
08/31/2018,Brooklyn,McCarren,Night Owl,1,4,5,19,15,34
08/30/2018,Brooklyn,McCarren,Night Owl,4,7,11,36,45,81
08/29/2018,Brooklyn,McCarren,Night Owl,6,8,14,41,46,87
08/28/2018,Brooklyn,McCarren,Night Owl,9,7,16,52,42,94
08/27/2018,Brooklyn,McCarren,Night Owl,10,9,19,46,55,101
08/31/2018,Brooklyn,Sunset,Night Owl,0,0,0,6,8,14
08/30/2018,Brooklyn,Sunset,Night Owl,0,0,0,25,23,48
08/29/2018,Brooklyn,Sunset,Night Owl,3,0,3,21,16,37
08/28/2018,Brooklyn,Sunset,Night Owl,0,2,2,13,18,31
08/27/2018,Brooklyn,Sunset,Night Owl,2,1,3,18,15,33
08/31/2018,Brooklyn,Red Hook,Night Owl,0,0,0,7,2,9
08/30/2018,Brooklyn,Red Hook,Night Owl,4,2,6,11,18,29
08/29/2018,Brooklyn,Red Hook,Night Owl,4,3,7,19,16,35
08/28/2018,Brooklyn,Red Hook,Night Owl,5,7,12,19,21,40
08/27/2018,Brooklyn,Red Hook,Night Owl,3,6,9,19,14,33
08/31/2018,Staten Island,Lyons,Night Owl,0,0,0,1,0,1
08/30/2018,Staten Island,Lyons,Night Owl,0,0,0,8,9,17
08/29/2018,Staten Island,Lyons,Night Owl,0,0,0,3,8,11
08/28/2018,Staten Island,Lyons,Night Owl,0,0,0,4,5,9
08/27/2018,Staten Island,Lyons,Night Owl,0,1,1,7,11,18
08/31/2018,Queens,Astoria,Night Owl,0,0,0,32,30,62
08/30/2018,Queens,Astoria,Night Owl,1,2,3,25,29,54
08/29/2018,Queens,Astoria,Night Owl,8,14,22,36,41,77
08/28/2018,Queens,Astoria,Night Owl,5,5,10,37,45,82
08/27/2018,Queens,Astoria,Night Owl,2,10,12,30,39,69
08/31/2018,Manhattan,Marcus Garvey,Night Owl,0,0,0,0,0,0
08/30/2018,Manhattan,Marcus Garvey,Night Owl,0,0,0,9,6,15
08/29/2018,Manhattan,Marcus Garvey,Night Owl,0,0,0,0,0,0
08/28/2018,Manhattan,Marcus Garvey,Night Owl,1,1,2,8,14,22
08/27/2018,Manhattan,Marcus Garvey,Night Owl,0,3,3,9,12,21
08/31/2018,Manhattan,Lasker,Night Owl,0,0,0,13,11,24
08/30/2018,Manhattan,Lasker,Night Owl,3,3,6,23,36,59
08/29/2018,Manhattan,Lasker,Night Owl,2,9,11,24,49,73
08/28/2018,Manhattan,Lasker,Night Owl,9,8,17,29,47,76
08/27/2018,Manhattan,Lasker,Night Owl,16,17,33,36,41,77
08/31/2018,Manhattan,John Jay,Night Owl,0,0,0,19,20,39
08/30/2018,Manhattan,John Jay,Night Owl,3,4,7,17,32,49
08/29/2018,Manhattan,John Jay,Night Owl,0,0,0,31,25,56
08/28/2018,Manhattan,John Jay,Night Owl,0,0,0,30,30,60
08/31/2018,Manhattan,Hamilton Fish,Night Owl,0,0,0,13,7,20
08/30/2018,Manhattan,Hamilton Fish,Night Owl,1,2,3,29,19,48
08/29/2018,Manhattan,Hamilton Fish,Night Owl,0,0,0,32,29,61
08/28/2018,Manhattan,Hamilton Fish,Night Owl,0,0,0,30,30,60
08/30/2018,Manhattan,Tony Dapolito,Night Owl,0,0,0,7,9,16
08/29/2018,Manhattan,Tony Dapolito,Night Owl,0,0,0,0,0,0
08/28/2018,Manhattan,Tony Dapolito,Night Owl,1,8,9,9,22,31
08/27/2018,Manhattan,John Jay,Night Owl,0,0,0,34,29,63
08/27/2018,Manhattan,Hamilton Fish,Night Owl,0,0,0,40,23,63
08/31/2018,Manhattan,Tony Dapolito,Night Owl,0,0,0,6,5,11
08/27/2018,Manhattan,Tony Dapolito,Night Owl,2,4,6,12,12,24
08/31/2018,Manhattan,Asser Levy,Night Owl,0,0,0,6,5,11
08/30/2018,Manhattan,Asser Levy,Night Owl,0,0,0,11,12,23
08/29/2018,Manhattan,Asser Levy,Night Owl,0,4,4,13,21,34
08/28/2018,Manhattan,Asser Levy,Night Owl,0,4,4,11,14,25
08/27/2018,Manhattan,Asser Levy,Night Owl,4,3,7,15,17,32
08/24/2018,Bronx,Crotona,Night Owl,0,0,0,3,2,5
08/23/2018,Bronx,Crotona,Night Owl,0,0,0,2,1,3
08/22/2018,Bronx,Crotona,Night Owl,0,0,0,4,2,6
08/21/2018,Bronx,Crotona,Night Owl,0,0,0,3,1,4
08/20/2018,Bronx,Crotona,Night Owl,0,0,0,3,2,5
08/24/2018,Bronx,Van Cortlandt,Night Owl,0,0,0,6,9,15
08/23/2018,Bronx,Van Cortlandt,Night Owl,2,1,3,2,3,5
08/22/2018,Bronx,Van Cortlandt,Night Owl,4,0,4,8,11,19
08/21/2018,Bronx,Van Cortlandt,Night Owl,0,0,0,2,8,10
08/20/2018,Bronx,Van Cortlandt,Night Owl,4,0,4,10,15,25
08/24/2018,Brooklyn,McCarren,Night Owl,1,5,6,35,26,61
08/23/2018,Brooklyn,McCarren,Night Owl,9,6,15,32,39,71
08/22/2018,Brooklyn,McCarren,Night Owl,4,7,11,37,49,86
08/21/2018,Brooklyn,McCarren,Night Owl,3,4,7,28,33,61
08/20/2018,Brooklyn,McCarren,Night Owl,11,12,23,36,28,64
08/24/2018,Brooklyn,Sunset,Night Owl,0,0,0,19,13,32
08/23/2018,Brooklyn,Sunset,Night Owl,0,1,1,9,14,23
08/22/2018,Brooklyn,Sunset,Night Owl,1,2,3,13,15,28
08/21/2018,Brooklyn,Sunset,Night Owl,1,1,2,19,12,31
08/20/2018,Brooklyn,Sunset,Night Owl,0,4,4,12,19,31
08/24/2018,Brooklyn,Red Hook,Night Owl,0,1,1,13,9,22
08/23/2018,Brooklyn,Red Hook,Night Owl,4,2,6,16,10,26
08/22/2018,Brooklyn,Red Hook,Night Owl,1,2,3,13,15,28
08/21/2018,Brooklyn,Red Hook,Night Owl,4,2,6,15,8,23
08/20/2018,Brooklyn,Red Hook,Night Owl,1,1,2,10,6,16
08/24/2018,Staten Island,Lyons,Night Owl,1,2,3,6,6,12
08/23/2018,Staten Island,Lyons,Night Owl,0,1,1,4,5,9
08/22/2018,Staten Island,Lyons,Night Owl,0,0,0,4,10,14
08/21/2018,Staten Island,Lyons,Night Owl,0,0,0,4,1,5
08/20/2018,Staten Island,Lyons,Night Owl,0,0,0,3,4,7
08/24/2018,Queens,Astoria,Night Owl,2,2,4,19,22,41
08/23/2018,Queens,Astoria,Night Owl,1,1,2,16,19,35
08/21/2018,Queens,Astoria,Night Owl,4,5,9,32,24,56
08/20/2018,Queens,Astoria,Night Owl,4,2,6,32,18,50
08/24/2018,Manhattan,Marcus Garvey,Night Owl,0,0,0,6,6,12
08/23/2018,Manhattan,Marcus Garvey,Night Owl,0,0,0,8,6,14
08/22/2018,Manhattan,Marcus Garvey,Night Owl,0,0,0,7,10,17
08/21/2018,Manhattan,Marcus Garvey,Night Owl,0,0,0,6,8,14
08/20/2018,Manhattan,Marcus Garvey,Night Owl,2,1,3,6,3,9
08/24/2018,Manhattan,Lasker,Night Owl,5,3,8,16,26,42
08/23/2018,Manhattan,Lasker,Night Owl,1,2,3,10,24,34
08/22/2018,Manhattan,Lasker,Night Owl,3,4,7,22,25,47
08/21/2018,Manhattan,Lasker,Night Owl,5,2,7,20,20,40
08/20/2018,Manhattan,Lasker,Night Owl,2,3,5,16,22,38
08/24/2018,Manhattan,John Jay,Night Owl,1,1,2,14,19,33
08/23/2018,Manhattan,John Jay,Night Owl,0,0,0,12,12,24
08/22/2018,Manhattan,John Jay,Night Owl,7,10,17,25,29,54
08/21/2018,Manhattan,John Jay,Night Owl,9,3,12,18,18,36
08/20/2018,Manhattan,John Jay,Night Owl,3,8,11,19,20,39
08/24/2018,Manhattan,Hamilton Fish,Night Owl,0,0,0,23,20,43
08/23/2018,Manhattan,Hamilton Fish,Night Owl,5,4,9,19,26,45
08/22/2018,Manhattan,Hamilton Fish,Night Owl,1,2,3,45,25,70
08/21/2018,Manhattan,Hamilton Fish,Night Owl,1,1,2,28,22,50
08/20/2018,Manhattan,Hamilton Fish,Night Owl,0,0,0,28,23,51
08/24/2018,Manhattan,Tony Dapolito,Night Owl,1,0,1,9,7,16
08/23/2018,Manhattan,Tony Dapolito,Night Owl,0,0,0,8,8,16
08/22/2018,Manhattan,Tony Dapolito,Night Owl,2,1,3,7,9,16
08/21/2018,Manhattan,Tony Dapolito,Night Owl,0,0,0,5,4,9
08/20/2018,Manhattan,Tony Dapolito,Night Owl,0,2,2,9,7,16
08/24/2018,Manhattan,Asser Levy,Night Owl,1,3,4,7,4,11
08/23/2018,Manhattan,Asser Levy,Night Owl,1,1,2,10,8,18
08/22/2018,Manhattan,Asser Levy,Night Owl,1,2,3,11,16,27
08/21/2018,Manhattan,Asser Levy,Night Owl,1,0,1,9,11,20
08/20/2018,Manhattan,Asser Levy,Night Owl,1,1,2,8,10,18
08/17/2018,Bronx,Crotona,Night Owl,0,0,0,0,0,0
08/16/2018,Bronx,Crotona,Night Owl,0,0,0,3,2,5
08/15/2018,Bronx,Crotona,Night Owl,0,0,0,3,4,7
08/14/2018,Bronx,Crotona,Night Owl,0,0,0,3,3,6
08/13/2018,Bronx,Crotona,Night Owl,1,0,1,1,0,1
08/17/2018,Bronx,Van Cortlandt,Night Owl,0,0,0,0,0,0
08/16/2018,Bronx,Van Cortlandt,Night Owl,0,0,0,4,15,19
08/15/2018,Bronx,Van Cortlandt,Night Owl,1,1,2,4,13,17
08/14/2018,Bronx,Van Cortlandt,Night Owl,4,1,5,8,5,13
08/13/2018,Bronx,Van Cortlandt,Night Owl,0,0,0,2,9,11
08/17/2018,Brooklyn,McCarren,Night Owl,2,2,4,0,0,0
08/16/2018,Brooklyn,McCarren,Night Owl,3,9,12,40,50,90
08/15/2018,Brooklyn,McCarren,Night Owl,8,10,18,51,64,115
08/14/2018,Brooklyn,McCarren,Night Owl,3,1,4,39,16,55
08/13/2018,Brooklyn,McCarren,Night Owl,6,0,6,38,22,60
08/17/2018,Brooklyn,Sunset,Night Owl,1,2,3,18,14,32
08/16/2018,Brooklyn,Sunset,Night Owl,3,1,4,20,22,42
08/15/2018,Brooklyn,Sunset,Night Owl,2,4,6,17,21,38
08/14/2018,Brooklyn,Sunset,Night Owl,1,1,2,10,9,19
08/13/2018,Brooklyn,Sunset,Night Owl,0,0,0,0,0,0
08/17/2018,Brooklyn,Red Hook,Night Owl,2,4,6,12,9,21
08/16/2018,Brooklyn,Red Hook,Night Owl,4,4,8,16,15,31
08/15/2018,Brooklyn,Red Hook,Night Owl,5,2,7,22,14,36
08/14/2018,Brooklyn,Red Hook,Night Owl,3,3,6,13,11,24
08/13/2018,Brooklyn,Red Hook,Night Owl,4,1,5,14,5,19
08/17/2018,Staten Island,Lyons,Night Owl,1,1,2,10,16,26
08/16/2018,Staten Island,Lyons,Night Owl,0,1,1,8,14,22
08/15/2018,Staten Island,Lyons,Night Owl,0,2,2,5,12,17
08/14/2018,Staten Island,Lyons,Night Owl,0,0,0,4,4,8
08/13/2018,Staten Island,Lyons,Night Owl,0,0,0,5,4,9
08/17/2018,Queens,Astoria,Night Owl,1,1,2,12,13,25
08/16/2018,Queens,Astoria,Night Owl,5,6,11,29,36,65
08/15/2018,Queens,Astoria,Night Owl,5,6,11,34,42,76
08/14/2018,Queens,Astoria,Night Owl,1,4,5,22,22,44
08/13/2018,Queens,Astoria,Night Owl,2,2,4,30,19,49
08/17/2018,Manhattan,Marcus Garvey,Night Owl,0,0,0,0,0,0
08/16/2018,Manhattan,Marcus Garvey,Night Owl,0,1,1,10,13,23
08/15/2018,Manhattan,Marcus Garvey,Night Owl,0,2,2,4,9,13
08/14/2018,Manhattan,Marcus Garvey,Night Owl,0,0,0,5,7,12
08/13/2018,Manhattan,Marcus Garvey,Night Owl,0,0,0,4,6,10
08/17/2018,Manhattan,Lasker,Night Owl,1,2,3,13,17,30
08/16/2018,Manhattan,Lasker,Night Owl,4,9,13,39,25,64
08/15/2018,Manhattan,Lasker,Night Owl,5,6,11,28,40,68
08/14/2018,Manhattan,Lasker,Night Owl,0,2,2,16,24,40
08/13/2018,Manhattan,Lasker,Night Owl,1,2,3,17,15,32
08/17/2018,Manhattan,John Jay,Night Owl,3,4,7,13,18,31
08/16/2018,Manhattan,John Jay,Night Owl,7,4,11,33,32,65
08/15/2018,Manhattan,John Jay,Night Owl,5,11,16,28,35,63
08/14/2018,Manhattan,John Jay,Night Owl,0,3,3,17,20,37
08/13/2018,Manhattan,John Jay,Night Owl,4,8,12,24,17,41
08/17/2018,Manhattan,Hamilton Fish,Night Owl,0,2,2,31,11,42
08/16/2018,Manhattan,Hamilton Fish,Night Owl,1,4,5,33,34,67
08/15/2018,Manhattan,Hamilton Fish,Night Owl,5,9,14,41,47,88
08/14/2018,Manhattan,Hamilton Fish,Night Owl,0,1,1,21,16,37
08/13/2018,Manhattan,Hamilton Fish,Night Owl,3,1,4,31,20,51
08/17/2018,Manhattan,Tony Dapolito,Night Owl,3,2,5,8,12,20
08/16/2018,Manhattan,Tony Dapolito,Night Owl,1,1,2,17,14,31
08/15/2018,Manhattan,Tony Dapolito,Night Owl,1,0,1,10,12,22
08/14/2018,Manhattan,Tony Dapolito,Night Owl,2,0,2,9,8,17
08/13/2018,Manhattan,Tony Dapolito,Night Owl,0,0,0,5,5,10
08/17/2018,Manhattan,Asser Levy,Night Owl,0,2,2,5,10,15
08/16/2018,Manhattan,Asser Levy,Night Owl,3,2,5,10,11,21
08/15/2018,Manhattan,Asser Levy,Night Owl,2,5,7,13,22,35
08/14/2018,Manhattan,Asser Levy,Night Owl,3,1,4,8,6,14
08/13/2018,Manhattan,Asser Levy,Night Owl,1,0,1,9,11,20
08/10/2018,Bronx,Crotona,Night Owl,0,0,0,5,3,8
08/09/2018,Bronx,Crotona,Night Owl,1,3,4,6,7,13
08/08/2018,Bronx,Crotona,Night Owl,0,1,1,5,4,9
08/07/2018,Bronx,Crotona,Night Owl,0,0,0,0,0,0
08/06/2018,Bronx,Crotona,Night Owl,0,0,0,0,0,0
08/10/2018,Bronx,Van Cortlandt,Night Owl,2,2,4,11,2,13
08/09/2018,Bronx,Van Cortlandt,Night Owl,4,6,10,8,18,26
08/08/2018,Bronx,Van Cortlandt,Night Owl,4,3,7,10,16,26
08/07/2018,Bronx,Van Cortlandt,Night Owl,0,1,1,0,0,0
08/10/2018,Brooklyn,McCarren,Night Owl,5,11,16,37,42,79
08/09/2018,Brooklyn,McCarren,Night Owl,10,9,19,53,50,103
08/08/2018,Brooklyn,McCarren,Night Owl,8,19,27,50,50,100
08/07/2018,Brooklyn,McCarren,Night Owl,0,0,0,0,0,0
08/10/2018,Brooklyn,Sunset,Night Owl,2,1,3,21,13,34
08/09/2018,Brooklyn,Sunset,Night Owl,2,7,9,22,27,49
08/08/2018,Brooklyn,Sunset,Night Owl,0,1,1,1,1,2
08/07/2018,Brooklyn,Sunset,Night Owl,0,0,0,0,0,0
08/10/2018,Brooklyn,Red Hook,Night Owl,2,2,4,15,10,25
08/08/2018,Brooklyn,Red Hook,Night Owl,2,9,11,16,24,40
08/07/2018,Brooklyn,Red Hook,Night Owl,0,0,0,0,0,0
08/06/2018,Brooklyn,Red Hook,Night Owl,3,2,5,0,0,0
08/10/2018,Staten Island,Lyons,Night Owl,1,1,2,6,5,11
08/09/2018,Staten Island,Lyons,Night Owl,1,4,5,10,17,27
08/10/2018,Queens,Astoria,Night Owl,4,6,10,29,34,63
08/09/2018,Queens,Astoria,Night Owl,10,14,24,47,41,88
08/10/2018,Manhattan,Marcus Garvey,Night Owl,0,1,1,3,6,9
08/09/2018,Manhattan,Marcus Garvey,Night Owl,2,3,5,10,14,24
08/10/2018,Manhattan,Lasker,Night Owl,6,7,13,22,31,53
08/09/2018,Manhattan,Lasker,Night Owl,6,5,11,28,32,60
08/08/2018,Staten Island,Lyons,Night Owl,0,1,1,5,4,9
08/08/2018,Queens,Astoria,Night Owl,12,19,31,49,44,93
08/08/2018,Manhattan,Marcus Garvey,Night Owl,6,5,11,15,14,29
08/08/2018,Manhattan,Lasker,Night Owl,8,12,20,30,38,68
08/07/2018,Staten Island,Lyons,Night Owl,0,0,0,0,0,0
08/07/2018,Queens,Astoria,Night Owl,0,0,0,0,0,0
08/07/2018,Manhattan,Marcus Garvey,Night Owl,0,0,0,0,0,0
08/07/2018,Manhattan,Lasker,Night Owl,1,1,2,3,4,7
08/10/2018,Manhattan,John Jay,Night Owl,6,12,18,13,25,38
08/10/2018,Manhattan,Hamilton Fish,Night Owl,2,6,8,38,31,69
08/10/2018,Manhattan,Tony Dapolito,Night Owl,3,1,4,9,12,21
08/10/2018,Manhattan,Asser Levy,Night Owl,0,0,0,0,0,0
08/09/2018,Manhattan,John Jay,Night Owl,6,13,19,23,30,53
08/09/2018,Manhattan,Hamilton Fish,Night Owl,11,14,25,48,65,113
08/09/2018,Manhattan,Tony Dapolito,Night Owl,2,3,5,12,16,28
08/09/2018,Manhattan,Asser Levy,Night Owl,3,4,7,13,15,28
08/08/2018,Manhattan,John Jay,Night Owl,8,12,20,32,30,62
08/08/2018,Manhattan,Hamilton Fish,Night Owl,7,6,13,40,34,74
08/08/2018,Manhattan,Tony Dapolito,Night Owl,2,6,8,10,16,26
08/08/2018,Manhattan,Asser Levy,Night Owl,1,2,3,7,17,24
08/07/2018,Manhattan,John Jay,Night Owl,0,0,0,0,0,0
08/07/2018,Manhattan,Hamilton Fish,Night Owl,0,0,0,0,0,0
08/07/2018,Manhattan,Tony Dapolito,Night Owl,0,0,0,0,0,0
08/07/2018,Manhattan,Asser Levy,Night Owl,0,0,0,0,0,0
08/06/2018,Bronx,Van Cortlandt,Night Owl,0,2,2,4,9,13
08/06/2018,Brooklyn,McCarren,Night Owl,3,2,5,0,0,0
08/06/2018,Brooklyn,Sunset,Night Owl,0,0,0,0,0,0
08/06/2018,Staten Island,Lyons,Night Owl,0,0,0,0,0,0
08/06/2018,Queens,Astoria,Night Owl,1,0,1,0,0,0
08/06/2018,Manhattan,Marcus Garvey,Night Owl,0,0,0,0,0,0
08/06/2018,Manhattan,Lasker,Night Owl,2,3,5,10,15,25
08/06/2018,Manhattan,John Jay,Night Owl,0,0,0,0,0,0
08/06/2018,Manhattan,Hamilton Fish,Night Owl,0,0,0,0,0,0
08/06/2018,Manhattan,Tony Dapolito,Night Owl,0,0,0,0,0,0
08/06/2018,Manhattan,Asser Levy,Night Owl,0,0,0,0,0,0
08/03/2018,Manhattan,Lasker,Night Owl,2,9,11,20,29,49
08/29/2018,Bronx,Crotona,Early Bird,0,0,0,2,2,4
08/28/2018,Bronx,Crotona,Early Bird,0,0,0,2,2,4
08/27/2018,Bronx,Crotona,Early Bird,1,0,1,2,2,4
08/29/2018,Bronx,Van Cortlandt,Early Bird,1,1,2,16,15,31
08/28/2018,Bronx,Van Cortlandt,Early Bird,0,1,1,12,13,25
08/27/2018,Bronx,Van Cortlandt,Early Bird,0,0,0,15,12,27
08/29/2018,Brooklyn,McCarren,Early Bird,3,9,12,61,69,130
08/28/2018,Brooklyn,McCarren,Early Bird,2,4,6,74,89,163
08/27/2018,Brooklyn,McCarren,Early Bird,5,2,7,56,45,101
08/29/2018,Manhattan,Sunset,Early Bird,0,1,1,37,58,95
08/28/2018,Brooklyn,Sunset,Early Bird,2,1,3,22,31,53
08/27/2018,Brooklyn,Sunset,Early Bird,1,3,4,22,32,54
08/29/2018,Brooklyn,Red Hook,Early Bird,3,3,6,24,36,60
08/28/2018,Brooklyn,Red Hook,Early Bird,2,3,5,24,34,58
08/27/2018,Brooklyn,Red Hook,Early Bird,1,0,1,19,34,53
08/29/2018,Staten Island,Lyons,Early Bird,1,0,1,8,12,20
08/28/2018,Staten Island,Astoria,Early Bird,0,0,0,7,11,18
08/27/2018,Staten Island,Lyons,Early Bird,0,0,0,9,12,21
08/29/2018,Queens,Astoria,Early Bird,1,0,1,43,59,102
08/28/2018,Queens,Astoria,Early Bird,1,1,2,39,62,101
08/27/2018,Queens,Astoria,Early Bird,2,1,3,34,40,74
08/29/2018,Manhattan,Jackie Robinson,Early Bird,0,0,0,7,21,28
08/28/2018,Manhattan,Jackie Robinson,Early Bird,0,1,1,8,20,28
08/27/2018,Manhattan,Jackie Robinson,Early Bird,0,1,1,8,22,30
08/29/2018,Manhattan,Thomas Jefferson,Early Bird,0,0,0,3,15,18
08/28/2018,Manhattan,Thomas Jefferson,Early Bird,0,1,1,3,12,15
08/27/2018,Manhattan,Thomas Jefferson,Early Bird,0,0,0,5,17,22
08/29/2018,Manhattan,Lasker,Early Bird,3,8,11,31,58,89
08/28/2018,Manhattan,Lasker,Early Bird,5,5,10,27,43,70
08/27/2018,Manhattan,Lasker,Early Bird,2,1,3,27,33,60
08/29/2018,Manhattan,John Jay,Early Bird,2,1,3,42,50,92
08/28/2018,Manhattan,John Jay,Early Bird,1,1,2,34,44,78
08/27/2018,Manhattan,John Jay,Early Bird,0,3,3,24,26,50
08/29/2018,Manhattan,Hamilton Fish,Early Bird,3,2,5,55,66,121
08/28/2018,Manhattan,Hamilton Fish,Early Bird,2,4,6,61,54,115
08/27/2018,Manhattan,Hamilton Fish,Early Bird,0,1,1,47,42,89
08/29/2018,Manhattan,Tony Dapolito,Early Bird,0,0,0,10,14,24
08/28/2018,Manhattan,Tony Dapolito,Early Bird,0,0,0,13,14,27
08/27/2018,Manhattan,Tony Dapolito,Early Bird,0,0,0,10,12,22
08/29/2018,Manhattan,Asser Levy,Early Bird,0,0,0,18,31,49
08/28/2018,Manhattan,Asser Levy,Early Bird,0,0,0,19,23,42
08/27/2018,Manhattan,Asser Levy,Early Bird,3,0,3,16,28,44
08/24/2018,Bronx,Crotona,Early Bird,0,0,0,1,1,2
08/23/2018,Bronx,Crotona,Early Bird,0,0,0,2,2,4
08/21/2018,Bronx,Crotona,Early Bird,0,0,0,2,2,4
08/20/2018,Bronx,Crotona,Early Bird,0,0,0,3,3,6
08/24/2018,Bronx,Van Cortlandt,Early Bird,1,0,1,10,11,21
08/22/2018,Bronx,Crotona,Early Bird,0,0,0,8,6,14
08/22/2018,Bronx,Van Cortlandt,Early Bird,0,0,0,14,7,21
08/21/2018,Bronx,Van Cortlandt,Early Bird,1,0,1,17,13,30
08/20/2018,Bronx,Van Cortlandt,Early Bird,0,1,1,12,11,23
08/24/2018,Brooklyn,McCarren,Early Bird,1,3,4,50,47,97
08/23/2018,Brooklyn,McCarren,Early Bird,0,4,4,49,42,91
08/22/2018,Brooklyn,McCarren,Early Bird,0,5,5,45,47,92
08/21/2018,Brooklyn,McCarren,Early Bird,3,3,6,53,59,112
08/20/2018,Brooklyn,McCarren,Early Bird,3,1,4,45,36,81
08/24/2018,Brooklyn,Sunset,Early Bird,1,1,2,16,26,42
08/23/2018,Brooklyn,Sunset,Early Bird,0,1,1,14,22,36
08/22/2018,Brooklyn,Sunset,Early Bird,1,0,1,19,18,37
08/21/2018,Brooklyn,Sunset,Early Bird,1,0,1,17,22,39
08/20/2018,Brooklyn,Sunset,Early Bird,1,3,4,16,22,38
08/24/2018,Brooklyn,Red Hook,Early Bird,1,0,1,23,29,52
08/23/2018,Brooklyn,Red Hook,Early Bird,1,0,1,26,13,39
08/22/2018,Brooklyn,Red Hook,Early Bird,0,0,0,15,19,34
08/21/2018,Brooklyn,Red Hook,Early Bird,1,0,1,25,13,38
08/20/2018,Brooklyn,Red Hook,Early Bird,4,3,7,19,22,41
08/24/2018,Staten Island,Lyons,Early Bird,0,0,0,5,0,5
08/23/2018,Staten Island,Lyons,Early Bird,0,0,0,4,10,14
08/22/2018,Staten Island,Lyons,Early Bird,0,1,1,5,9,14
08/21/2018,Staten Island,Lyons,Early Bird,1,0,1,6,11,17
08/20/2018,Staten Island,Lyons,Early Bird,1,0,1,9,11,20
08/24/2018,Queens,Astoria,Early Bird,3,1,4,37,46,83
08/23/2018,Queens,Astoria,Early Bird,0,2,2,37,27,64
08/22/2018,Queens,Astoria,Early Bird,0,2,2,37,39,76
08/21/2018,Queens,Astoria,Early Bird,1,1,2,31,35,66
08/20/2018,Queens,Astoria,Early Bird,0,0,0,33,50,83
08/24/2018,Manhattan,Jackie Robinson,Early Bird,0,0,0,5,17,22
08/23/2018,Manhattan,Jackie Robinson,Early Bird,0,0,0,1,15,16
08/22/2018,Manhattan,Jackie Robinson,Early Bird,1,0,1,7,18,25
08/21/2018,Manhattan,Jackie Robinson,Early Bird,0,0,0,5,15,20
08/20/2018,Manhattan,Jackie Robinson,Early Bird,1,3,4,3,23,26
08/24/2018,Manhattan,Thomas Jefferson,Early Bird,0,0,0,3,10,13
08/23/2018,Manhattan,Thomas Jefferson,Early Bird,1,0,1,3,7,10
08/22/2018,Manhattan,Thomas Jefferson,Early Bird,1,0,1,4,7,11
08/21/2018,Manhattan,Thomas Jefferson,Early Bird,0,0,0,6,11,17
08/20/2018,Manhattan,Thomas Jefferson,Early Bird,1,0,1,5,8,13
08/24/2018,Manhattan,Lasker,Early Bird,5,1,6,27,36,63
08/23/2018,Manhattan,Lasker,Early Bird,1,1,2,24,27,51
08/22/2018,Manhattan,Lasker,Early Bird,3,2,5,30,34,64
08/21/2018,Manhattan,Lasker,Early Bird,5,3,8,31,35,66
08/20/2018,Manhattan,Lasker,Early Bird,0,1,1,24,22,46
08/23/2018,Manhattan,John Jay,Early Bird,0,0,0,18,24,42
08/22/2018,Manhattan,John Jay,Early Bird,5,2,7,31,30,61
08/21/2018,Manhattan,John Jay,Early Bird,9,5,14,36,33,69
08/20/2018,Manhattan,John Jay,Early Bird,2,5,7,21,26,47
08/24/2018,Manhattan,Hamilton Fish,Early Bird,0,0,0,44,48,92
08/23/2018,Manhattan,Hamilton Fish,Early Bird,0,0,0,27,25,52
08/22/2018,Manhattan,Hamilton Fish,Early Bird,1,1,2,44,44,88
08/21/2018,Manhattan,Hamilton Fish,Early Bird,2,3,5,39,43,82
08/20/2018,Manhattan,Hamilton Fish,Early Bird,4,1,5,43,25,68
08/24/2018,Manhattan,Tony Dapolito,Early Bird,0,0,0,12,26,38
08/23/2018,Manhattan,Tony Dapolito,Early Bird,0,0,0,10,14,24
08/22/2018,Manhattan,Tony Dapolito,Early Bird,1,0,1,5,7,12
08/21/2018,Manhattan,Tony Dapolito,Early Bird,0,1,1,10,17,27
08/20/2018,Manhattan,Tony Dapolito,Early Bird,0,0,0,6,15,21
08/24/2018,Manhattan,Asser Levy,Early Bird,0,0,0,12,21,33
08/23/2018,Manhattan,Asser Levy,Early Bird,1,0,1,18,19,37
08/22/2018,Manhattan,Asser Levy,Early Bird,0,0,0,17,19,36
08/21/2018,Manhattan,Asser Levy,Early Bird,1,1,2,18,24,42
08/20/2018,Manhattan,Asser Levy,Early Bird,1,2,3,16,30,46
08/17/2018,Bronx,Crotona,Early Bird,0,0,0,6,5,11
08/16/2018,Bronx,Crotona,Early Bird,0,0,0,4,5,9
08/15/2018,Bronx,Crotona,Early Bird,0,0,0,3,3,6
08/14/2018,Bronx,Crotona,Early Bird,0,0,0,5,3,8
08/13/2018,Bronx,Crotona,Early Bird,1,0,1,4,0,4
08/17/2018,Bronx,Van Cortlandt,Early Bird,0,1,1,20,16,36
08/16/2018,Bronx,Van Cortlandt,Early Bird,0,0,0,15,13,28
08/15/2018,Bronx,Van Cortlandt,Early Bird,0,0,0,15,21,36
08/14/2018,Bronx,Van Cortlandt,Early Bird,4,0,4,14,13,27
08/13/2018,Bronx,Van Cortlandt,Early Bird,1,0,1,9,6,15
08/17/2018,Brooklyn,McCarren,Early Bird,5,5,10,70,63,133
08/16/2018,Brooklyn,McCarren,Early Bird,8,3,11,69,84,153
08/15/2018,Brooklyn,McCarren,Early Bird,4,11,15,56,71,127
08/14/2018,Brooklyn,McCarren,Early Bird,4,4,8,54,59,113
08/13/2018,Brooklyn,McCarren,Early Bird,1,4,5,37,43,80
08/17/2018,Brooklyn,Sunset,Early Bird,1,0,1,22,33,55
08/16/2018,Brooklyn,Sunset,Early Bird,2,2,4,22,28,50
08/15/2018,Brooklyn,Sunset,Early Bird,1,8,9,23,36,59
08/14/2018,Brooklyn,Sunset,Early Bird,0,1,1,23,23,46
08/13/2018,Brooklyn,Sunset,Early Bird,0,2,2,23,25,48
08/17/2018,Brooklyn,Red Hook,Early Bird,2,2,4,16,27,43
08/16/2018,Brooklyn,Red Hook,Early Bird,1,3,4,22,36,58
08/15/2018,Brooklyn,Red Hook,Early Bird,1,2,3,18,23,41
08/14/2018,Brooklyn,Red Hook,Early Bird,2,0,2,21,19,40
08/13/2018,Brooklyn,Red Hook,Early Bird,0,0,0,16,14,30
08/17/2018,Staten Island,Lyons,Early Bird,0,1,1,6,11,17
08/16/2018,Staten Island,Lyons,Early Bird,0,0,0,6,11,17
08/15/2018,Staten Island,Lyons,Early Bird,0,1,1,6,10,16
08/14/2018,Staten Island,Lyons,Early Bird,0,0,0,7,13,20
08/13/2018,Staten Island,Lyons,Early Bird,1,0,1,9,12,21
08/17/2018,Queens,Astoria,Early Bird,0,1,1,44,65,109
08/16/2018,Queens,Astoria,Early Bird,2,1,3,39,54,93
08/15/2018,Queens,Astoria,Early Bird,0,2,2,38,64,102
08/14/2018,Queens,Astoria,Early Bird,3,5,8,36,46,82
08/13/2018,Queens,Astoria,Early Bird,0,0,0,24,27,51
08/17/2018,Manhattan,Jackie Robinson,Early Bird,0,1,1,12,22,34
08/16/2018,Manhattan,Jackie Robinson,Early Bird,2,1,3,16,30,46
08/15/2018,Manhattan,Jackie Robinson,Early Bird,2,0,2,14,30,44
08/14/2018,Manhattan,Jackie Robinson,Early Bird,2,1,3,11,25,36
08/13/2018,Manhattan,Jackie Robinson,Early Bird,2,4,6,6,31,37
08/17/2018,Manhattan,Thomas Jefferson,Early Bird,1,1,2,5,13,18
08/16/2018,Manhattan,Thomas Jefferson,Early Bird,0,0,0,5,10,15
08/15/2018,Manhattan,Thomas Jefferson,Early Bird,0,0,0,6,11,17
08/14/2018,Manhattan,Thomas Jefferson,Early Bird,0,0,0,5,9,14
08/13/2018,Manhattan,Thomas Jefferson,Early Bird,1,1,2,3,12,15
08/17/2018,Manhattan,Lasker,Early Bird,1,6,7,38,47,85
08/16/2018,Manhattan,Lasker,Early Bird,1,0,1,25,38,63
08/15/2018,Manhattan,Lasker,Early Bird,5,6,11,44,43,87
08/14/2018,Manhattan,Lasker,Early Bird,1,1,2,27,33,60
08/13/2018,Manhattan,Lasker,Early Bird,2,0,2,21,32,53
08/17/2018,Manhattan,John Jay,Early Bird,7,4,11,35,38,73
08/16/2018,Manhattan,John Jay,Early Bird,7,8,15,30,36,66
08/15/2018,Manhattan,John Jay,Early Bird,1,5,6,28,43,71
08/14/2018,Manhattan,John Jay,Early Bird,3,4,7,27,32,59
08/13/2018,Manhattan,John Jay,Early Bird,1,4,5,21,34,55
08/17/2018,Manhattan,Hamilton Fish,Early Bird,2,8,10,63,73,136
08/16/2018,Manhattan,Hamilton Fish,Early Bird,2,1,3,52,56,108
08/15/2018,Manhattan,Hamilton Fish,Early Bird,3,4,7,56,61,117
08/14/2018,Manhattan,Hamilton Fish,Early Bird,2,3,5,43,54,97
08/13/2018,Manhattan,Hamilton Fish,Early Bird,1,0,1,31,27,58
08/17/2018,Manhattan,Tony Dapolito,Early Bird,2,2,4,10,19,29
08/16/2018,Manhattan,Tony Dapolito,Early Bird,0,1,1,7,17,24
08/15/2018,Manhattan,Tony Dapolito,Early Bird,1,0,1,10,17,27
08/14/2018,Manhattan,Tony Dapolito,Early Bird,0,0,0,13,18,31
08/13/2018,Manhattan,Tony Dapolito,Early Bird,2,1,3,9,13,22
08/17/2018,Manhattan,Asser Levy,Early Bird,0,0,0,16,29,45
08/16/2018,Manhattan,Asser Levy,Early Bird,0,1,1,15,26,41
08/15/2018,Manhattan,Asser Levy,Early Bird,0,1,1,13,26,39
08/14/2018,Manhattan,Asser Levy,Early Bird,0,1,1,13,22,35
08/13/2018,Manhattan,Asser Levy,Early Bird,0,1,1,10,23,33
08/10/2018,Bronx,Crotona,Early Bird,1,0,1,5,0,5
08/09/2018,Bronx,Crotona,Early Bird,0,0,0,4,3,7
08/08/2018,Bronx,Crotona,Early Bird,0,0,0,6,3,9
08/10/2018,Bronx,Van Cortlandt,Early Bird,0,3,3,18,22,40
08/09/2018,Bronx,Van Cortlandt,Early Bird,0,2,2,13,15,28
08/08/2018,Bronx,Van Cortlandt,Early Bird,1,2,3,17,18,35
08/10/2018,Brooklyn,Sunset,Early Bird,0,0,0,23,33,56
08/09/2018,Brooklyn,Sunset,Early Bird,2,2,4,27,32,59
08/08/2018,Brooklyn,Sunset,Early Bird,1,4,5,28,37,65
08/10/2018,Brooklyn,McCarren,Early Bird,3,9,12,61,70,131
08/09/2018,Brooklyn,McCarren,Early Bird,7,10,17,71,70,141
08/08/2018,Brooklyn,McCarren,Early Bird,10,13,23,93,79,172
08/10/2018,Brooklyn,Red Hook,Early Bird,4,3,7,24,37,61
08/09/2018,Brooklyn,Red Hook,Early Bird,2,4,6,26,34,60
08/08/2018,Brooklyn,Red Hook,Early Bird,2,9,11,26,30,56
08/10/2018,Staten Island,Lyons,Early Bird,0,1,1,10,13,23
08/09/2018,Staten Island,Lyons,Early Bird,1,2,3,8,15,23
08/08/2018,Staten Island,Lyons,Early Bird,0,1,1,8,13,21
08/10/2018,Queens,Astoria,Early Bird,2,1,3,49,53,102
08/09/2018,Queens,Astoria,Early Bird,4,2,6,46,49,95
08/08/2018,Queens,Astoria,Early Bird,4,5,9,58,101,159
08/10/2018,Manhattan,Jackie Robinson,Early Bird,1,5,6,12,31,43
08/09/2018,Manhattan,Jackie Robinson,Early Bird,1,1,2,11,27,38
08/08/2018,Manhattan,Jackie Robinson,Early Bird,2,2,4,14,26,40
08/10/2018,Manhattan,Thomas Jefferson,Early Bird,1,0,1,4,10,14
08/09/2018,Manhattan,Thomas Jefferson,Early Bird,1,1,2,6,14,20
08/08/2018,Manhattan,Thomas Jefferson,Early Bird,0,10,10,3,15,18
08/10/2018,Manhattan,Lasker,Early Bird,3,7,10,45,54,99
08/09/2018,Manhattan,Lasker,Early Bird,3,3,6,36,36,72
08/08/2018,Manhattan,Lasker,Early Bird,8,2,10,38,49,87
08/10/2018,Manhattan,John Jay,Early Bird,7,16,23,37,54,91
08/09/2018,Manhattan,John Jay,Early Bird,7,8,15,28,50,78
08/08/2018,Manhattan,John Jay,Early Bird,3,7,10,42,57,99
08/10/2018,Manhattan,Hamilton Fish,Early Bird,4,4,8,75,53,128
08/09/2018,Manhattan,Hamilton Fish,Early Bird,4,6,10,60,58,118
08/08/2018,Manhattan,Hamilton Fish,Early Bird,4,3,7,80,53,133
08/10/2018,Manhattan,Tony Dapolito,Early Bird,1,1,2,12,15,27
08/09/2018,Manhattan,Tony Dapolito,Early Bird,0,3,3,14,20,34
08/08/2018,Manhattan,Tony Dapolito,Early Bird,2,1,3,12,17,29
08/10/2018,Manhattan,Asser Levy,Early Bird,1,1,2,14,23,37
08/09/2018,Manhattan,Asser Levy,Early Bird,2,4,6,23,29,52
08/08/2018,Manhattan,Asser Levy,Early Bird,1,1,2,20,33,53
08/07/2018,Bronx,Crotona,Early Bird,0,1,1,3,4,7
08/07/2018,Bronx,Van Cortlandt,Early Bird,1,2,3,19,20,39
08/07/2018,Brooklyn,McCarren,Early Bird,14,12,26,85,82,167
08/07/2018,Brooklyn,Sunset,Early Bird,0,0,0,28,36,64
08/07/2018,Brooklyn,Red Hook,Early Bird,3,4,7,25,33,58
08/07/2018,Staten Island,Lyons,Early Bird,0,1,1,7,17,24
08/07/2018,Queens,Astoria,Early Bird,3,5,8,52,64,116
08/07/2018,Manhattan,Jackie Robinson,Early Bird,2,3,5,8,30,38
08/07/2018,Manhattan,Thomas Jefferson,Early Bird,1,0,1,7,15,22
08/07/2018,Manhattan,Lasker,Early Bird,4,8,12,38,55,93
08/07/2018,Manhattan,John Jay,Early Bird,1,6,7,24,41,65
08/07/2018,Manhattan,Hamilton Fish,Early Bird,2,2,4,87,55,142
08/07/2018,Manhattan,Tony Dapolito,Early Bird,0,5,5,13,22,35
08/07/2018,Manhattan,Asser Levy,Early Bird,3,4,7,21,35,56
08/06/2018,Bronx,Crotona,Early Bird,0,0,0,2,3,5
08/06/2018,Bronx,Van Cortlandt,Early Bird,2,1,3,19,18,37
08/06/2018,Brooklyn,McCarren,Early Bird,7,14,21,72,61,133
08/06/2018,Brooklyn,Sunset,Early Bird,1,4,5,26,38,64
08/06/2018,Brooklyn,Red Hook,Early Bird,3,6,9,26,37,63
08/06/2018,Staten Island,Lyons,Early Bird,0,1,1,6,12,18
08/06/2018,Queens,Astoria,Early Bird,3,6,9,48,55,103
08/06/2018,Manhattan,Jackie Robinson,Early Bird,0,3,3,9,32,41
08/06/2018,Manhattan,Thomas Jefferson,Early Bird,0,0,0,5,15,20
08/06/2018,Manhattan,Lasker,Early Bird,5,2,7,33,47,80
08/06/2018,Manhattan,John Jay,Early Bird,5,3,8,34,42,76
08/06/2018,Manhattan,Hamilton Fish,Early Bird,4,7,11,68,54,122
08/06/2018,Manhattan,Tony Dapolito,Early Bird,1,0,1,13,14,27
08/06/2018,Manhattan,Asser Levy,Early Bird,0,2,2,21,41,62
08/03/2018,Bronx,Crotona,Early Bird,0,0,0,3,3,6
08/03/2018,Bronx,Van Cortlandt,Early Bird,0,2,2,14,18,32
08/03/2018,Brooklyn,McCarren,Early Bird,5,2,7,57,43,100
08/03/2018,Brooklyn,Sunset,Early Bird,0,2,2,27,31,58
08/03/2018,Brooklyn,Red Hook,Early Bird,2,4,6,22,31,53
08/03/2018,Staten Island,Lyons,Early Bird,0,0,0,10,11,21
08/03/2018,Queens,Astoria,Early Bird,4,4,8,53,54,107
08/03/2018,Manhattan,Jackie Robinson,Early Bird,0,3,3,7,29,36
08/03/2018,Manhattan,Thomas Jefferson,Early Bird,2,1,3,9,15,24
08/03/2018,Manhattan,Lasker,Early Bird,2,5,7,38,43,81
08/03/2018,Manhattan,John Jay,Early Bird,8,9,17,32,34,66
08/03/2018,Manhattan,Hamilton Fish,Early Bird,2,2,4,57,60,117
08/03/2018,Manhattan,Tony Dapolito,Early Bird,1,1,2,13,21,34
08/03/2018,Manhattan,Asser Levy,Early Bird,0,1,1,20,20,40
08/02/2018,Bronx,Crotona,Early Bird,1,0,1,5,3,8
08/02/2018,Bronx,Van Cortlandt,Early Bird,0,1,1,13,18,31
08/02/2018,Brooklyn,McCarren,Early Bird,5,5,10,72,72,144
08/02/2018,Brooklyn,Sunset,Early Bird,0,0,0,30,29,59
08/02/2018,Brooklyn,Red Hook,Early Bird,1,4,5,18,36,54
08/02/2018,Staten Island,Lyons,Early Bird,3,0,3,10,6,16
08/02/2018,Queens,Astoria,Early Bird,0,4,4,42,51,93
08/02/2018,Manhattan,Jackie Robinson,Early Bird,2,3,5,11,28,39
08/02/2018,Manhattan,Thomas Jefferson,Early Bird,0,2,2,4,13,17
08/02/2018,Manhattan,Lasker,Early Bird,5,2,7,33,47,80
08/02/2018,Manhattan,John Jay,Early Bird,7,5,12,34,37,71
08/02/2018,Manhattan,Hamilton Fish,Early Bird,1,6,7,71,57,128
08/02/2018,Manhattan,Tony Dapolito,Early Bird,0,0,0,14,19,33
08/02/2018,Manhattan,Asser Levy,Early Bird,0,1,1,21,27,48
08/01/2018,Bronx,Crotona,Early Bird,0,0,0,1,3,4
08/01/2018,Bronx,Van Cortlandt,Early Bird,0,0,0,8,5,13
08/01/2018,Brooklyn,McCarren,Early Bird,2,2,4,34,28,62
08/01/2018,Brooklyn,Sunset,Early Bird,0,0,0,30,29,59
08/01/2018,Brooklyn,Red Hook,Early Bird,1,2,3,15,6,21
08/01/2018,Staten Island,Lyons,Early Bird,0,0,0,8,3,11
08/01/2018,Queens,Astoria,Early Bird,1,1,2,21,28,49
08/01/2018,Manhattan,Jackie Robinson,Early Bird,0,0,0,4,16,20
08/01/2018,Manhattan,Thomas Jefferson,Early Bird,0,0,0,6,3,9
08/01/2018,Manhattan,Lasker,Early Bird,5,5,10,34,40,74
08/01/2018,Manhattan,John Jay,Early Bird,2,2,4,16,19,35
08/01/2018,Manhattan,Hamilton Fish,Early Bird,2,2,4,30,22,52
08/01/2018,Manhattan,Tony Dapolito,Early Bird,0,0,0,9,8,17
08/01/2018,Manhattan,Asser Levy,Early Bird,0,2,2,13,14,27
07/31/2018,Bronx,Crotona,Early Bird,0,0,0,5,5,10
07/31/2018,Bronx,Van Cortlandt,Early Bird,0,1,1,19,13,32
07/31/2018,Brooklyn,McCarren,Early Bird,8,5,13,74,61,135
07/31/2018,Brooklyn,Sunset,Early Bird,1,2,3,28,30,58
07/31/2018,Brooklyn,Red Hook,Early Bird,3,4,7,23,33,56
07/31/2018,Staten Island,Lyons,Early Bird,0,1,1,9,8,17
07/31/2018,Queens,Astoria,Early Bird,2,3,5,48,48,96
07/31/2018,Manhattan,Jackie Robinson,Early Bird,3,2,5,9,23,32
07/31/2018,Manhattan,Thomas Jefferson,Early Bird,0,1,1,9,12,21
08/03/2018,Bronx,Crotona,Night Owl,1,0,1,5,2,7
08/02/2018,Bronx,Crotona,Night Owl,0,0,0,4,1,5
08/01/2018,Bronx,Crotona,Night Owl,0,0,0,5,1,6
07/31/2018,Bronx,Crotona,Night Owl,1,0,1,4,2,6
07/30/2018,Bronx,Crotona,Night Owl,1,1,2,5,3,8
08/03/2018,Bronx,Van Cortlandt,Night Owl,2,3,5,14,6,20
08/02/2018,Bronx,Van Cortlandt,Night Owl,1,0,1,12,12,24
08/01/2018,Bronx,Van Cortlandt,Night Owl,0,4,4,14,19,33
07/31/2018,Bronx,Van Cortlandt,Night Owl,1,1,2,6,8,14
07/31/2018,Manhattan,Lasker,Early Bird,5,5,10,34,40,74
08/03/2018,Brooklyn,McCarren,Night Owl,6,8,14,36,39,75
07/31/2018,Manhattan,John Jay,Early Bird,1,3,4,32,29,61
08/02/2018,Brooklyn,McCarren,Night Owl,2,16,18,40,56,96
08/01/2018,Brooklyn,McCarren,Night Owl,15,16,31,55,65,120
07/31/2018,Manhattan,Hamilton Fish,Early Bird,6,4,10,76,55,131
07/31/2018,Brooklyn,McCarren,Night Owl,0,2,2,51,49,100
07/30/2018,Brooklyn,McCarren,Night Owl,7,9,16,38,58,96
07/31/2018,Manhattan,Tony Dapolito,Early Bird,0,1,1,12,17,29
08/03/2018,Brooklyn,Sunset,Night Owl,4,4,8,23,17,40
08/02/2018,Brooklyn,Sunset,Night Owl,2,4,6,23,26,49
07/31/2018,Manhattan,Asser Levy,Early Bird,0,2,2,20,29,49
08/01/2018,Brooklyn,Sunset,Night Owl,3,8,11,22,31,53
07/31/2018,Brooklyn,Sunset,Night Owl,3,6,9,29,29,58
07/30/2018,Brooklyn,Sunset,Night Owl,3,2,5,27,16,43
07/30/2018,Bronx,Crotona,Early Bird,0,0,0,2,3,5
08/03/2018,Brooklyn,Red Hook,Night Owl,4,1,5,13,18,31
08/02/2018,Brooklyn,Red Hook,Night Owl,2,5,7,24,21,45
08/01/2018,Brooklyn,Red Hook,Night Owl,3,1,4,11,19,30
07/31/2018,Brooklyn,Red Hook,Night Owl,3,2,5,18,13,31
07/30/2018,Bronx,Van Cortlandt,Early Bird,2,1,3,20,17,37
07/30/2018,Brooklyn,Red Hook,Night Owl,4,3,7,24,12,36
08/03/2018,Staten Island,Lyons,Night Owl,0,1,1,9,10,19
08/02/2018,Staten Island,Lyons,Night Owl,2,0,2,7,8,15
08/01/2018,Staten Island,Lyons,Night Owl,1,0,1,7,10,17
07/30/2018,Brooklyn,McCarren,Early Bird,8,7,15,58,50,108
07/31/2018,Staten Island,Lyons,Night Owl,1,1,2,5,14,19
07/30/2018,Staten Island,Lyons,Night Owl,2,0,2,6,9,15
07/30/2018,Brooklyn,Red Hook,Early Bird,3,3,6,25,31,56
08/03/2018,Queens,Astoria,Night Owl,2,5,7,39,33,72
07/30/2018,Staten Island,Lyons,Early Bird,1,1,2,9,13,22
08/02/2018,Queens,Astoria,Night Owl,5,9,14,35,47,82
08/01/2018,Queens,Astoria,Night Owl,6,10,16,47,53,100
07/30/2018,Queens,Astoria,Early Bird,2,2,4,50,51,101
07/30/2018,Manhattan,Jackie Robinson,Early Bird,2,1,3,9,25,34
07/31/2018,Queens,Astoria,Night Owl,8,18,26,49,61,110
07/30/2018,Queens,Astoria,Night Owl,5,2,7,38,28,66
07/30/2018,Manhattan,Thomas Jefferson,Early Bird,1,1,2,7,13,20
08/03/2018,Manhattan,Marcus Garvey,Night Owl,1,1,2,6,6,12
08/02/2018,Manhattan,Marcus Garvey,Night Owl,1,1,2,6,9,15
08/01/2018,Manhattan,Marcus Garvey,Night Owl,3,4,7,11,10,21
07/30/2018,Manhattan,Lasker,Early Bird,3,6,9,39,45,84
07/31/2018,Manhattan,Marcus Garvey,Night Owl,2,0,2,10,12,22
07/30/2018,Manhattan,Marcus Garvey,Night Owl,0,1,1,8,3,11
08/02/2018,Manhattan,Lasker,Night Owl,8,6,14,20,29,49
07/30/2018,Manhattan,John Jay,Early Bird,2,2,4,37,37,74
07/30/2018,Manhattan,Hamilton Fish,Early Bird,9,7,16,55,49,104
08/01/2018,Manhattan,Lasker,Night Owl,5,12,17,24,42,66
07/30/2018,Manhattan,Tony Dapolito,Early Bird,2,0,2,16,14,30
07/31/2018,Manhattan,Lasker,Night Owl,9,15,24,26,41,67
07/30/2018,Manhattan,Lasker,Night Owl,1,5,6,17,20,37
08/03/2018,Manhattan,John Jay,Night Owl,5,4,9,25,23,48
08/02/2018,Manhattan,John Jay,Night Owl,5,6,11,21,23,44
08/01/2018,Manhattan,John Jay,Night Owl,5,10,15,23,29,52
07/30/2018,Manhattan,Asser Levy,Early Bird,3,0,3,19,30,49
07/31/2018,Manhattan,John Jay,Night Owl,5,10,15,35,37,72
07/30/2018,Manhattan,John Jay,Night Owl,6,8,14,30,13,43
08/03/2018,Manhattan,Hamilton Fish,Night Owl,4,8,12,44,31,75
08/02/2018,Manhattan,Hamilton Fish,Night Owl,2,10,12,45,41,86
08/01/2018,Manhattan,Hamilton Fish,Night Owl,3,5,8,50,31,81
07/27/2018,Bronx,Crotona,Early Bird,0,0,0,3,7,10
07/31/2018,Manhattan,Hamilton Fish,Night Owl,1,3,4,46,44,90
07/30/2018,Manhattan,Hamilton Fish,Night Owl,8,3,11,53,36,89
07/27/2018,Bronx,Van Cortlandt,Early Bird,1,2,3,19,17,36
08/03/2018,Manhattan,Tony Dapolito,Night Owl,1,4,5,13,15,28
08/02/2018,Manhattan,Tony Dapolito,Night Owl,1,2,3,3,13,16
08/01/2018,Manhattan,Tony Dapolito,Night Owl,0,2,2,12,9,21
07/31/2018,Manhattan,Tony Dapolito,Night Owl,2,2,4,15,14,29
07/30/2018,Manhattan,Tony Dapolito,Night Owl,3,4,7,6,9,15
07/27/2018,Brooklyn,Sunset,Early Bird,3,5,8,34,35,69
08/03/2018,Manhattan,Asser Levy,Night Owl,2,3,5,14,11,25
08/02/2018,Manhattan,Asser Levy,Night Owl,4,2,6,15,17,32
08/01/2018,Manhattan,Asser Levy,Night Owl,0,1,1,27,21,48
07/31/2018,Manhattan,Asser Levy,Night Owl,3,7,10,14,21,35
07/30/2018,Manhattan,Asser Levy,Night Owl,0,1,1,6,14,20
07/27/2018,Brooklyn,Red Hook,Early Bird,1,3,4,35,57,92
07/27/2018,Staten Island,Lyons,Early Bird,0,0,0,6,9,15
07/27/2018,Bronx,Crotona,Night Owl,0,0,0,0,0,0
07/27/2018,Bronx,Van Cortlandt,Night Owl,0,0,0,0,0,0
07/27/2018,Brooklyn,McCarren,Night Owl,0,1,1,0,0,0
07/27/2018,Queens,Astoria,Early Bird,2,5,7,52,51,103
07/27/2018,Brooklyn,Sunset,Night Owl,0,0,0,0,0,0
07/27/2018,Brooklyn,Red Hook,Night Owl,0,0,0,0,0,0
07/27/2018,Staten Island,Lyons,Night Owl,0,0,0,0,0,0
07/27/2018,Queens,Astoria,Night Owl,0,1,1,0,0,0
07/27/2018,Manhattan,Marcus Garvey,Night Owl,0,0,0,0,0,0
07/27/2018,Manhattan,Lasker,Night Owl,0,0,0,0,0,0
07/27/2018,Manhattan,John Jay,Night Owl,0,0,0,0,0,0
07/27/2018,Manhattan,Hamilton Fish,Night Owl,0,0,0,0,0,0
07/26/2018,Bronx,Crotona,Early Bird,2,0,2,5,2,7
07/27/2018,Manhattan,Tony Dapolito,Night Owl,0,0,0,0,0,0
07/27/2018,Manhattan,Asser Levy,Night Owl,0,0,0,0,0,0
07/26/2018,Bronx,Van Cortlandt,Early Bird,2,2,4,21,19,40
07/26/2018,Bronx,Crotona,Night Owl,0,0,0,7,2,9
07/26/2018,Bronx,Van Cortlandt,Night Owl,2,1,3,8,18,26
07/26/2018,Brooklyn,McCarren,Early Bird,2,4,6,50,42,92
07/26/2018,Brooklyn,McCarren,Night Owl,13,15,28,51,76,127
07/26/2018,Brooklyn,Sunset,Night Owl,5,7,12,25,24,49
07/26/2018,Brooklyn,Red Hook,Night Owl,2,4,6,19,13,32
07/26/2018,Staten Island,Lyons,Night Owl,3,0,3,8,12,20
07/26/2018,Queens,Astoria,Night Owl,7,6,13,36,42,78
07/27/2018,Brooklyn,McCarren,Early Bird,6,6,12,73,72,145
07/26/2018,Manhattan,Marcus Garvey,Night Owl,6,6,12,16,16,32
07/26/2018,Brooklyn,Sunset,Early Bird,1,1,2,31,27,58
07/26/2018,Manhattan,Lasker,Night Owl,9,11,20,33,39,72
07/26/2018,Manhattan,John Jay,Night Owl,5,14,19,19,33,52
07/26/2018,Manhattan,Hamilton Fish,Night Owl,5,8,13,54,39,93
07/26/2018,Brooklyn,Red Hook,Early Bird,1,3,4,31,30,61
07/26/2018,Manhattan,Tony Dapolito,Night Owl,4,1,5,18,17,35
07/26/2018,Manhattan,Asser Levy,Night Owl,3,3,6,11,14,25
07/26/2018,Staten Island,Lyons,Early Bird,0,0,0,9,13,22
07/26/2018,Queens,Astoria,Early Bird,0,0,0,46,44,90
07/25/2018,Manhattan,Jackie Robinson,Early Bird,0,0,0,0,5,5
07/25/2018,Bronx,Crotona,Night Owl,0,0,0,1,1,2
07/25/2018,Bronx,Van Cortlandt,Night Owl,0,0,0,6,4,10
07/26/2018,Manhattan,Jackie Robinson,Early Bird,1,3,4,6,26,32
07/25/2018,Manhattan,Marcus Garvey,Night Owl,0,0,0,6,3,9
07/25/2018,Brooklyn,McCarren,Night Owl,3,1,4,18,10,28
07/25/2018,Brooklyn,Sunset,Night Owl,0,0,0,12,10,22
07/25/2018,Brooklyn,Red Hook,Night Owl,2,1,3,12,6,18
07/26/2018,Manhattan,Thomas Jefferson,Early Bird,2,0,2,10,13,23
07/25/2018,Staten Island,Lyons,Night Owl,0,1,1,2,6,8
07/25/2018,Queens,Astoria,Night Owl,1,0,1,18,20,38
07/25/2018,Bronx,Crotona,Early Bird,0,0,0,2,3,5
07/25/2018,Manhattan,Lasker,Night Owl,2,2,4,20,8,28
07/25/2018,Manhattan,John Jay,Night Owl,2,2,4,16,11,27
07/25/2018,Bronx,Van Cortlandt,Early Bird,0,0,0,5,1,6
07/25/2018,Brooklyn,McCarren,Early Bird,0,1,1,15,18,33
07/25/2018,Manhattan,Tony Dapolito,Night Owl,1,0,1,4,5,9
07/25/2018,Brooklyn,Sunset,Early Bird,0,0,0,0,0,0
07/25/2018,Brooklyn,Red Hook,Early Bird,1,0,1,7,2,9
07/25/2018,Staten Island,Lyons,Early Bird,0,0,0,5,5,10
07/25/2018,Queens,Astoria,Early Bird,1,2,3,21,18,39
07/27/2018,Manhattan,Thomas Jefferson,Early Bird,0,0,0,6,16,22
07/27/2018,Manhattan,Lasker,Early Bird,4,4,8,38,157,195
07/25/2018,Manhattan,Thomas Jefferson,Early Bird,0,1,1,2,8,10
07/27/2018,Manhattan,Jackie Robinson,Early Bird,1,2,3,13,31,44
07/06/2018,Manhattan,Jackie Robinson,Early Bird,3,11,14,6,22,28
07/05/2018,Manhattan,Jackie Robinson,Early Bird,10,29,39,10,29,39
07/26/2018,Manhattan,Lasker,Early Bird,6,5,11,33,44,77
07/25/2018,Manhattan,Lasker,Early Bird,0,0,0,11,19,30
07/24/2018,Manhattan,Lasker,Early Bird,3,5,8,25,41,66
07/23/2018,Manhattan,Lasker,Early Bird,1,0,1,14,18,32
07/20/2018,Manhattan,Lasker,Early Bird,3,12,15,47,44,91
07/19/2018,Manhattan,Lasker,Early Bird,7,6,13,36,44,80
07/18/2018,Manhattan,Lasker,Early Bird,6,8,14,38,52,90
07/17/2018,Manhattan,Lasker,Early Bird,2,3,5,31,41,72
07/16/2018,Manhattan,Lasker,Early Bird,10,10,20,43,52,95
07/13/2018,Manhattan,Lasker,Early Bird,6,10,16,42,49,91
07/12/2018,Manhattan,Lasker,Early Bird,3,7,10,24,33,57
07/11/2018,Manhattan,Lasker,Early Bird,21,15,36,46,45,91
07/10/2018,Manhattan,Lasker,Early Bird,15,28,43,36,50,86
07/09/2018,Manhattan,Lasker,Early Bird,13,19,32,33,43,76
07/06/2018,Manhattan,Lasker,Early Bird,8,4,12,16,14,30
07/05/2018,Manhattan,Lasker,Early Bird,30,47,77,30,47,77
07/05/2018,Manhattan,Hamilton Fish,Night Owl,52,47,99,52,47,99
07/06/2018,Manhattan,Hamilton Fish,Night Owl,16,12,28,41,24,65
07/09/2018,Manhattan,Hamilton Fish,Night Owl,27,39,66,62,64,126
07/10/2018,Manhattan,Hamilton Fish,Night Owl,24,20,44,57,50,107
07/11/2018,Manhattan,Hamilton Fish,Night Owl,17,21,38,55,48,103
07/12/2018,Manhattan,Hamilton Fish,Night Owl,13,13,26,53,38,91
07/13/2018,Manhattan,Hamilton Fish,Night Owl,7,16,23,74,60,134
07/16/2018,Manhattan,Hamilton Fish,Night Owl,23,14,37,74,60,134
07/17/2018,Manhattan,Hamilton Fish,Night Owl,0,4,4,20,15,35
07/18/2018,Manhattan,Hamilton Fish,Night Owl,6,7,13,57,44,101
07/19/2018,Manhattan,Hamilton Fish,Night Owl,8,7,15,46,39,85
07/20/2018,Manhattan,Hamilton Fish,Night Owl,8,9,17,43,32,75
07/23/2018,Manhattan,Hamilton Fish,Night Owl,11,5,16,56,41,97
07/24/2018,Manhattan,Hamilton Fish,Night Owl,7,1,8,56,35,91
07/25/2018,Manhattan,Hamilton Fish,Night Owl,3,2,5,31,20,51
07/05/2018,Manhattan,Asser Levy,Night Owl,7,6,13,12,11,23
07/06/2018,Manhattan,Asser Levy,Night Owl,7,6,13,12,11,23
07/09/2018,Manhattan,Asser Levy,Night Owl,17,13,30,23,20,43
07/10/2018,Manhattan,Asser Levy,Night Owl,7,16,23,19,28,47
07/11/2018,Manhattan,Asser Levy,Night Owl,4,9,13,16,20,36
07/12/2018,Manhattan,Asser Levy,Night Owl,1,3,4,9,19,28
07/13/2018,Manhattan,Asser Levy,Night Owl,3,4,7,10,14,24
07/16/2018,Manhattan,Asser Levy,Night Owl,3,9,12,14,26,40
07/17/2018,Manhattan,Asser Levy,Night Owl,2,1,3,7,8,15
07/18/2018,Manhattan,Asser Levy,Night Owl,3,5,8,11,22,33
07/19/2018,Manhattan,Asser Levy,Night Owl,1,2,3,7,15,22
07/20/2018,Manhattan,Asser Levy,Night Owl,3,6,9,12,17,29
07/23/2018,Manhattan,Asser Levy,Night Owl,4,3,7,11,15,26
07/24/2018,Manhattan,Asser Levy,Night Owl,1,2,3,14,16,30
07/25/2018,Manhattan,Asser Levy,Night Owl,0,2,2,89,9,98
07/26/2018,Manhattan,John Jay,Early Bird,4,2,6,35,34,69
07/25/2018,Manhattan,John Jay,Early Bird,0,1,1,7,16,23
07/24/2018,Manhattan,John Jay,Early Bird,2,1,3,32,31,63
07/23/2018,Manhattan,John Jay,Early Bird,0,0,0,15,22,37
07/20/2018,Manhattan,John Jay,Early Bird,13,28,41,37,51,88
07/19/2018,Manhattan,John Jay,Early Bird,2,4,6,32,43,75
07/18/2018,Manhattan,John Jay,Early Bird,8,4,12,37,47,84
07/17/2018,Manhattan,John Jay,Early Bird,2,6,8,24,34,58
07/16/2018,Manhattan,John Jay,Early Bird,8,13,21,33,56,89
07/26/2018,Manhattan,Hamilton Fish,Early Bird,1,1,2,53,42,95
07/25/2018,Manhattan,Hamilton Fish,Early Bird,1,1,2,22,12,34
07/24/2018,Manhattan,Hamilton Fish,Early Bird,3,1,4,57,39,96
07/23/2018,Manhattan,Hamilton Fish,Early Bird,1,0,1,15,14,29
07/20/2018,Manhattan,Hamilton Fish,Early Bird,8,10,18,70,74,144
07/19/2018,Manhattan,Hamilton Fish,Early Bird,5,5,10,66,49,115
07/18/2018,Manhattan,Hamilton Fish,Early Bird,8,8,16,74,63,137
07/17/2018,Manhattan,Hamilton Fish,Early Bird,11,9,20,74,64,138
07/16/2018,Manhattan,Hamilton Fish,Early Bird,12,11,23,74,58,132
07/13/2018,Manhattan,Hamilton Fish,Early Bird,4,8,12,68,64,132
07/12/2018,Manhattan,Hamilton Fish,Early Bird,7,6,13,63,44,107
07/11/2018,Manhattan,Hamilton Fish,Early Bird,11,17,28,74,57,131
07/10/2018,Manhattan,Hamilton Fish,Early Bird,27,9,36,77,39,116
07/26/2018,Manhattan,Tony Dapolito,Early Bird,0,1,1,10,20,30
07/25/2018,Manhattan,Tony Dapolito,Early Bird,1,0,1,7,5,12
07/24/2018,Manhattan,Tony Dapolito,Early Bird,1,0,1,14,16,30
07/23/2018,Manhattan,Tony Dapolito,Early Bird,0,0,0,5,7,12
07/20/2018,Manhattan,Tony Dapolito,Early Bird,1,1,2,13,18,31
07/19/2018,Manhattan,Tony Dapolito,Early Bird,2,2,4,14,21,35
07/18/2018,Manhattan,Tony Dapolito,Early Bird,1,1,2,14,15,29
07/17/2018,Manhattan,Tony Dapolito,Early Bird,3,6,9,13,19,32
07/16/2018,Manhattan,Tony Dapolito,Early Bird,3,5,8,14,17,31
07/26/2018,Manhattan,Asser Levy,Early Bird,0,0,0,21,20,41
07/25/2018,Manhattan,Asser Levy,Early Bird,1,0,1,7,5,12
07/24/2018,Manhattan,Asser Levy,Early Bird,0,0,0,20,18,38
07/23/2018,Manhattan,Asser Levy,Early Bird,1,0,1,15,14,29
07/20/2018,Manhattan,Asser Levy,Early Bird,4,1,5,23,29,52
07/19/2018,Manhattan,Asser Levy,Early Bird,3,6,9,25,26,51
07/18/2018,Manhattan,Asser Levy,Early Bird,3,1,4,22,24,46
07/17/2018,Manhattan,Asser Levy,Early Bird,4,5,9,19,30,49
07/16/2018,Manhattan,Asser Levy,Early Bird,2,4,6,21,33,54
07/13/2018,Manhattan,John Jay,Early Bird,8,15,23,30,46,76
07/12/2018,Manhattan,John Jay,Early Bird,3,6,9,22,38,60
07/11/2018,Manhattan,John Jay,Early Bird,11,13,24,42,46,88
07/10/2018,Manhattan,John Jay,Early Bird,34,33,67,30,38,68
07/09/2018,Manhattan,John Jay,Early Bird,20,20,40,36,38,74
07/06/2018,Manhattan,John Jay,Early Bird,23,34,57,30,49,79
07/05/2018,Manhattan,John Jay,Early Bird,35,40,75,14,16,30
07/09/2018,Manhattan,Hamilton Fish,Early Bird,4,8,12,68,64,132
07/06/2018,Manhattan,Hamilton Fish,Early Bird,7,3,10,15,39,54
07/05/2018,Manhattan,Hamilton Fish,Early Bird,57,46,103,57,46,103
07/13/2018,Manhattan,Tony Dapolito,Early Bird,1,4,5,14,19,33
07/12/2018,Manhattan,Tony Dapolito,Early Bird,6,5,11,11,18,29
07/11/2018,Manhattan,Tony Dapolito,Early Bird,7,5,12,21,17,38
07/10/2018,Manhattan,Tony Dapolito,Early Bird,8,7,15,15,18,33
07/09/2018,Manhattan,Tony Dapolito,Early Bird,7,5,12,17,17,34
07/06/2018,Manhattan,Tony Dapolito,Early Bird,1,3,4,6,10,16
07/05/2018,Manhattan,Tony Dapolito,Early Bird,9,15,24,9,15,24
07/13/2018,Manhattan,Asser Levy,Early Bird,4,3,7,15,27,42
07/12/2018,Manhattan,Asser Levy,Early Bird,1,3,4,15,31,46
07/11/2018,Manhattan,Asser Levy,Early Bird,9,9,18,23,30,53
07/10/2018,Manhattan,Asser Levy,Early Bird,5,9,14,20,24,44
07/09/2018,Manhattan,Asser Levy,Early Bird,9,12,21,19,30,49
07/06/2018,Manhattan,Asser Levy,Early Bird,7,5,12,10,10,20
07/05/2018,Manhattan,Asser Levy,Early Bird,13,25,38,13,25,38
